Author	Quote
Seymoure Cray	#3 pencils and quadrille pads.
Lisa Kleypas	... I discovered life sometimes has a way of giving you what you need, but not in the form you expect.
Robin Wall Kimmerer	...all flourishing is mutual.
Wendelin Van Draanen	...Next time you're faced with a choice, do the right thing. It hurts everyone less in the long run.
David Mitchell	...there ain't no journey what don't change you some.
Mark Twain	A banker is a fellow who lends you his umbrella when the sun is shining, but wants it back the minute it begins to rain.
Gordana Biernat	A belief is simply a thought that seems true to YOU.
Carl Sagan	A book is proof that humans are capable of working magic.
Unknown	A cauliflower is a plant explosion in extremely slow motion.
Jack Dempsey	A champion is someone who gets up when he can't.
Brian Tracy	A clear vision, backed by definite plans, gives you a tremendous feeling of confidence and personal power.
ST. CLEMENT	A companion is but another self; wherefore it is an argument that a man is wicked if he keep company with the wicked.
Richelle E. Goodrich	A daily dose of daydreaming heals the heart, soothes the soul, and strengthens the imagination.
Henry Kissinger	A diamond is merely a lump of coal that did well under pressure.
Johnny Depp	A dishonest man you can always trust to be dishonest.
Donna McGoff	A dream is a seed.Vision plants it.Imagination nurtures growth.Opportunities create blooms.Thoughts become things!
Walt Disney Company	A dream is a wish your heart makes, when you're fast asleep.
	A family is a place where principles are hammered and honed on the anvil of everyday living.
Jim Morrison	A friend is someone who gives you total freedom to be yourself.
Unknown	A friend of mine tried to annoy me with bird puns, but I soon realized that toucan play at that game.
Publilius Syrus	A friendship that can end never really began.
Unknown	A genius lives in every one of us. Each day more and more heavily…
Antoine de Saint-Exupéry	A goal without a plan is just a wish.
William Styron	A good book should leave you, slightly exhausted at the end. You live several lives while reading it.
Arthur Brisbane	A good friend can tell you what is the matter with you in a minute. He may not seem such a good friend after telling.
Arthur C. Clarke	A hundred failures would not matter, when one single success could change the destiny of the world.
Steve Maraboli	A lack of clarity could put the brakes on any journey to success.
Sunday Adelaja	A lack of knowledge always leads to defeat and destruction
Abhijit Naskar	A library is more precious than a bank.
Lord Samuel	A library is thought in cold storage.
Suzy Kassem	A life fueled by passions is like riding on the back of a dragon.
George Bernard Shaw	A life spent making mistakes is not only more honorable, but more useful than a life spent doing nothing.
Thomas Jefferson	A little rebellion now and then is a good thing.
	A little rebellion now and then... is a medicine necessary for the sound health of government.
Zig Ziglar	A lot of people have gone further than they thought they could because someone else thought they could
Janvier Chouteu-Chando	A man has a hard time feeling fulfilled when he lives a life that does not serve a purpose that is more than himself.
Ralph Waldo Emerson	A man is known by the books he reads.
	A man's respect for law and order exists in precise relationship to the size of his paycheck.
Bill Gaede	A mathematician believes that describing the speed of Mercury with equations amounts to science.
Paul Erdos	A mathematician is a device for turning coffee into theorems.
Mary Kay Ash	A mediocre idea that generates enthusiasm will go further than a great idea that inspires no one.
Sir Joshua Reynolds	A mere copier of nature can never produce anything great.
Chuck Palahniuk	A minute of perfection was worth the effort. A moment was the most you could ever expect from perfection.
Benjamin Franklin	A Penny Saved is a Penny Earned
Kristy McMorlan	A person can influence a situation or the situation can influence a person.
	A polar bear is a rectangular bear after a coordinate transform.
David Lloyd George	A politician was a person with whose politics you did not agree. When you did agree, he was a statesman.
Rajen Jani	A positive change in approach improves quality.
Lord John Russell	A proverb is one man's wit and all men's wisdom.
Anthony Robbins	A real decision is measured by the fact that you've taken a new action. If there's no action, you haven't truly decided.
Walter Winchell	A real friend is one who walks in when the rest of the world walk out.
Marcus Tullius Cicero	A room without books is like a body without a soul.
Gordon Lindsay Glegg	A scientist can discover a new star but he cannot make one. He would have to ask an engineer to do it for him.
HOSEA BALLOU	A single bad habit will mar an otherwise faultless character, as an ink drop soileth the pure white page.
Leo Buscaglia	A single rose can be my garden… a single friend, my world.
Thomas Fuller	A stumble may prevent a fall.
	A sub-clerk in the post-office is the equal of a conqueror if consciousness is common to them.
Isaac Asimov	A subtle thought that is in error may yet give rise to fruitful inquiry that can establish truths of great value.
Colleen Houck	A tiger only needs three things to be comfortable. Lots of food, sleep, and…actually, no it's just those two things.
Benjamin Franklin	A true friend is the best Possession.
Voltaire	A witty saying proves nothing.
Toni Sorenson	A wolf searches the path for prey that has paused. Keep moving.
Marcus Aurelius	Accept whatever comes to you woven in the pattern of your destiny, for what could more aptly fit your needs?
Roy T. Bennett	Accept yourself, love yourself, and keep moving forward. If you want to fly, you have to give up what weighs you down.
Steve Maraboli	Accept yourself, your strengths, your weaknesses, your truths, and know what tools you have to fulfill your purpose.
Mario Puzo	Accidents don't happen to people who take accidents as a personal insult.
	According to my calculations, this problem doesn't exist.
Abraham Lincoln	Achievement has no color
Jiddu Krishnamurti	Acquiring knowledge is a form of imitation.
idowu koyenikan	Acquiring wisdom is great but it is not the goal, applying it is.
William James	Act as if what you do makes a difference. It does.
Mahatma Gandhi	Action expresses priorities.
Steve Maraboli	Action is the universal language of success.
Dale Carnegie	Actions speak louder than words, and a smile says, 'I like you. You make me happy. I am glad to see you.
Roy T. Bennett	Acts of Kindness: A random act of kindness, no matter how small, can make a tremendous impact on someone else's life. 
William Bernbach	Advertising is fundamentally persuasion and persuasion happens to be not a science, but an art.
Stephen Leacock	Advertising: the science of arresting the human intelligence long enough to get money from it.
Samuel Taylor Coleridge	Advice is like snow; the softer it falls, the longer it dwells upon, and the deeper it sinks into the mind.
Mary Kay Ash	Aerodynamically, the bumble bee shouldn't be able to fly, but the bumble bee doesn't know it so it goes on flying anyway.
	Affection is a garden, and without it there would not be a verdant spot on the surface of the globe.
Gustave Droz	Affection is catching
V.E. Schwab	After all, if you run far enough, no one can catch you.
	After all, life is really simple; we ourselves create the circumstances that complicate it.
	After several annoying incidents, our school finally implemented thorough security upgrades for their devices
Robert W. Service	Ah! the clock is always slow; It is later than you think.
Bob Dylan	Ah, but I was so much older then Im younger than that now
Suzanne Collins	Aim higher in case you fall short.
John Ruskin	All art is but dirtying the paper delicately.
Ford Taylor	All feedback is relevant, even if it's not true.
	All governments suffer a recurring problem: Power attracts pathological personalities.
Carl Sagan	All inquiries carry with them some element of risk.
Jacqueline Carey	All knowledge is worth having.
Albert Einstein	All of science is nothing more than the refinement of everyday thinking.
Samuel Butler	All progress is based upon a universal innate desire on the part of every organism to live beyond its income.
Buddha	All that we are is the result of what we have thought.
Robert Frost	All the fun's in how you say a thing.
Nikola Tesla	All these observations fascinate us, and fill us with an intense desire to know more about the nature of these phenomena.
Criss Jami	All things remarkable are surprisingly simple; albeit difficult to find.
Mark Twain	All You Need In This Life Is Ignorance And Confidence,And Then Success Is Sure.
Santosh Kalwar	Always be like a water. Float in the times of pain or dance like waves along the wind which touches its surface.
Abraham Lincoln	Always bear in mind that your own resolution to succeed, is more important than any other one thing.
Ralph Waldo Emerson	Always do what you are afraid to do.
Kerri Maniscalco	Always foster and grow that unquenchable curiosity of yours
Margaret Mead	Always remember that you are absolutely unique. Just like everyone else.
Johnnie Dent Jr.	Always take failure as an opinion; never as an option.
Laurence J. Peter	America is a country that doesn't know where it is going but is determined to set a speed record getting there.
James Michener	America is a nation with many flaws, but hopes so vast that only the cowardly would refuse to acknowledge them.
Solange nicole	An apple a day keeps the doctor away. But eating too many, is quite enough-plenty. And you'll have to go see the good doc anyway.
John Tukey.	An approximate answer to the right problem is worth a good deal more than an exact answer to an approximate problem.
	An army without culture is a dull-witted army, and a dull-witted army cannot defeat the enemy.
John O’Hara	An artist is his own fault.
Hervé Le Tellier	An attentive reader will always learn more, and more quickly, from good authors than from life.
Debasish Mridha MD	An attitude of gratitude is the best outfit to wear when looking for success and happiness.
An Arts graduate's view of engineers	An engineer is someone who is good with figures, but doesn't have the personality of an accountant.
Stephen Hawking	An expanding universe does not preclude a creator, but it does place limits on when he might have carried out his job!
H.L. Mencken	An idealist is one who, on noticing that a rose smells better than a cabbage, concludes that it makes a better soup.
Gilbert Keith Chesterton	An inconvenience is only an adventure wrongly considered; an adventure is an inconvenience rightly considered.
Jodi Picoult	And I remembered something else that makes us human: faith, the only weapon in our arsenal to battle doubt.
Steve Jobs	And the only way to do great work is to love what you do.... Don't settle
Jane Austen	And to all this she must yet add something more substantial, in the improvement of her mind by extensive reading.
Galileo Galilei	And, believe me, if I were again beginning my studies, I should follow the advice of Plato and start with mathematics.
Maya Angelou	Any book that helps a child to form a habit of reading, to make reading one of his deep and continuing needs, is good for him.
Rajen Jani	Any work not executed honestly, fails to fulfill its objective.
	Anybody caught selling macrame in public should be dyed a natural color and hung out to dry.
Sarah Dessen	Anyone can hide. Facing up to things, working through them, that's what makes you strong.
John von Neumann	Anyone who attempts to generate random numbers by deterministic means is, of course, living in a state of sin.
Michel Houellebecq	Anything can happen in life, especially nothing.
Besa Kosova	Anything worthy is worth the fight!
Margaret Cousins	Appreciation can change a day, even change a life. Your willingness to put it into words is all that is necessary.
	Appreciation is a wonderful thing. It makes what is excellent in others belong to us as well.
	Arguments are like fire-arms which a man may keep at home but should not carry about with him.
Carl Sandburg	Arithmetic is numbers you squeeze from your head to your hand to your pencil to your paper till you get the answer.
Ivan Fernandez	Art can help us reclaim a sense of wonder in our lives.
Wilson Mizner	Art is science made clear.
Henry Petroski	As engineers, we were going to be in a position to change the world - not just study it.
MASON	As every thread of gold is valuable, so is every minute of time.
Unknown	As I get older and remember all the people I've lost along the way. I think to myself maybe a career as a tour guide wasn't for me.
Nikola Tesla	As I review the events of my past life I realize how subtle are the influences that shape our destinies.
Joan Baez	As long as one keeps searching, the answers come.
	As love without esteem is capricious and volatile; esteem without love is languid and cold.
Mark Twain	As to the Adjective: when in doubt, strike it out.
John F. Kennedy	As we express our gratitude, we must never forget that the highest appreciation is not to utter words, but to live by them.
Bangambiki Habyarimana	As you fight any war, sometimes the result may be defeat. Learn to be heroic even in your defeats.
Mark Twain	Assertion is not proof
Woody Allen	Astronomers say the universe is finite, which is a comforting thought for those people who can't remember where they leave things.
Queen Elizabeth II	At its heart, engineering is about using science to find creative, practical solutions. It is a noble profession.
Germany Kent	At the end of the day friendship proves itself more through your deeds than words could ever speak.
Robert Asprin	At there blackest wehn thinsg are, two myself I say, 'cheer up, worse things could bee. ' and sure enuf, worse they get.
John Milton	Awake, arise or be for ever fall'n.
Sherry Yard	Baking is both an art and a science.
	Baseball fans love numbers. They love to swirl them around their mouths like Bordeaux wine.
Daisy Gallagher	Be armed with purpose, persistence and intention and the enemy called defeat will choose another to battle.
Lisa Genova	Be creative, be useful, be practical, be generous and finish big
Scott Cook	Be dramatically willing to focus on the customer at all costs, even at the cost of obsoleting your own stuff.
Alan Cohen	Be happy with what you have. Be excited about what you want.
Serbian Proverb	Be humble for you are made of earth. Be noble for you are made of stars.
Ken Poirot	Be humble: have the courage to speak the truth.
Dean F. Wilson	Be idealistic about the future, be realistic about the present, and never forget the lessons of the past.
A.P.J. Abdul Kalam	Be more dedicated to making solid achievements than in running after swift but synthetic happiness.
Roy T. Bennett	Be patient and open-minded in your interactions with others; find the positive attributes that they possess.
Steve Martin	Be so good they can't ignore you.
Meister Eckhart	Be willing to be a beginner every single morning.
Heraclitus	Because it is so unbelievable, the truth often escapes being known.
Steve Martin	Before you criticize a man, walk a mile in his shoes. That way, when you do criticize him, you'll be a mile away and have his shoes.
	Before you've practiced, the theory is useless. After you've practiced, the theory is obvious.
Abhijit Naskar	Being articulate is not the same as being wise. Truth devoid of conscience, is worthless in human existence.
Caitlin Miller	Being brave sometimes means letting someone hold you together when you're falling apart.
Abraham Lincoln	Being elected to Congress, though I am very grateful to our friends, for having done it, has not pleased me as much as I expected.
William Butler Yeats	Being Irish, he had an abiding sense of tragedy, which sustained him through temporary periods of joy.
Timothy Ferriss	Being selective-doing less-is the path of the productive. Focus on the important few and ignore the rest.
John Franks	Being thankful should be an unwritten rule of life because there are several things to be thankful for.
Charles Kettering	Believe and act as if it were impossible to fail.
Roy T. Bennett	Believe in Your Heart. Believe in your heart that you're meant to live a life full of passion, purpose, magic and miracles. 
Sunday Adelaja	Believe that your life is not ordinary and never look down on what you can do to impact a life.
Benjamin Franklin	Beware of little expenses; a small leak will sink a great ship.
Thabiso Daniel Monkoe	Birds don't eat canned worms
George Eliot	Blessed is the man, who having nothing to say, abstains from giving wordy evidence of the fact.
Stephen King	Books are a uniquely portable magic.
Carl Sagan	Books are like seeds. They can lie dormant for centuries and then flower in the most unpromising soil.
Dr T.P.Chia	Books are more than educational - they are the quiet friends, loyal companions, and untiring teachers.
Helen Exley	Books can be dangerous. The best ones should be labeled 'This could change your life'.
Anthony Powell	Books do furnish a room.
	Books have the same enemies as people - fire, humidity, animals, weather, and their own content.
Christopher Moore	Boredom can be a lethal thing on a small island.
J. Robert Oppenheimer	Both the man of science and the man of action live always at the edge of mystery, surrounded by it.
Susan Gable	Breathe in, take what life hands you; hold it, accept it; breathe out, let it go.
Ntathu Allen	Breathing and sitting in silence allows you the space to find your joy and what matters most to you.
Fyodor Dostoevsky	But how could you live and have no story to tell?
Evan Peters	BUT I LOVE HALLOWEEN, AND I LOVE THAT FEELING: THE COLD AIR, THE SPOOKY DANGERS LURKING AROUND THE CORNER.
Francis Darwin	But in science the credit goes to the man who convinces the world, not to the man to whom the idea first occurs.
J.R.R. Tolkien	But in the end it's only a passing thing, this shadow; even darkness must pass.
Ivan Pavlov	But man has still another powerful resource: natural science with its strictly objective methods.
Michael Faraday	But still try for who knows what is possible!
George Weinberg	But the cure for most obstacles is, Be decisive.
Aldous Huxley	But then the course of events takes no account of verisimilitude. Fiction has to be probable; fact does not.
Joseph Butler	But to us, probability is the very guide of life.
James Patterson	But what is life if you don't live it?
Galileo Galilei	By denying scientific principles, one may maintain any paradox.
Israelmore Ayivor	Calamities reveal your capabilities. Take note of this and when times get odd, prepare and shine.
John von Neumann	Can we survive technology?
Shannon Alder	Carve your name on hearts, not tombstones. A legacy is etched into the minds of others and the stories they share about you.
Garrison Keillor	Cats are intended to teach us that not everything in nature has a purpose.
Debasish Mridha MD	Celebrate every day, every moment, every success and every failure. Life is a celebration of love and consciousness.
	Champions aren't made in gyms. Champions are made from something they have deep inside them.
Thomas Le Hoang	Champions know the emotions you want to feel and help you feel them by remaining genuine to a noble intention.
Debasish Mridha MD	Change is inevitable, but choice defines the direction of change. So, define choice to find success and happiness.
Michelle Cook-Hall	Change your perspective and change your life
Mason Cooley	Children pay little attention to their parents' teachings, but reproduce their characters faithfully
P.C. Cast and Kristin Cast	Choose battles that you can win without losing your heart and your soul.
None	Christmas is the joyous time of year when a box could equally contain a puzzle, socks, or computer game.
Euripides	Cleverness is not wisdom.
Robert A. Heinlein	Climate is what you expect, weather is what you get.
Abhijit Naskar	Come out my friend. Come out from the narrow lanes of darkness into the vivacious light of the day.
Rene Descartes	Common sense is the most widely shared commodity in the world, for every man is convinced that he is well supplied with it.
Jack Horner	Comparing science and religion isn't like comparing apples and oranges - it's more like apples and sewing machines.
Hlovate	Complex question can only be solved by patience.
Isaac Asimov	Computers are better than we are at arithmetic, not because computers are so good at it, but because we are so bad at it.
Rajen Jani	Conflicts are expensive.
Rajen Jani	Conflicts have small beginnings.
Dr. Seuss	Congratulations! Today is your day. You're off to Great Places! You're off and away!
H. L. Mencken	Conscience: the inner voice which warns us that someone may be looking.
Bill Bryson	Consider the Lichen. Lichens are just about the hardiest visible organisms on Earth, but the least ambitious.
Myra Yadav	Cooking food is a science but making people hungry is an art
John Quincy Adams	Courage and perseverance have a magical talisman, before which difficulties disappear and obstacles vanish into air.
Red Haircrow	Dance above the surface of the world. Let your thoughts lift you into creativity that is not hampered by opinion.
Dan Brown	Darkness feeds on apathy.
	Dear algebra: stop asking us to find your X: he's not coming back.
Toni Sorenson	Deep breath. Positive thought. Firm resolve. Now go out there and grab that dream with your name already on it.
Evan Esar	Definition of Statistics: The science of producing unreliable facts from reliable figures.
COLTON	Deliberate with caution, but act with decision; and yield with graciousness, or oppose with firmness.
H. L. Mencken	Democracy is the art and science of running the circus from the monkey cage.
Pedro Domingos	Despite all its successes, machine learning is still in the alchemy stage of science.
Unknown	Did you hear about the math teacher who's afraid of negative numbers? He will stop at nothing to avoid them.
Unknown	Did you hear about the tailor who shredded all the neckwear? His company severed all ties.
Johann Wolfgang von Goethe	Difficulties increase the nearer we get to the goal.
	Disciples be damned. It's not interesting. It's only the masters that matter. Those who create.
Thomas Edison	Discontent is the first necessity of progress.
Sujit Lalwani	Discovering While Doing Is Natural...But,Doing Immediately After Discovering Is The Attitude of Winners!
Albert Szent-Gyorgyi	Discovery consists of looking at the same thing as everyone else and thinking something different.
Henry David Thoreau	Distrust any enterprise that requires new clothes.
Patricia Cornwell	Do no harm and leave the world a better place than you found it.
John Burroughs	Do not despise your own place and hour. Every place is under the stars, every place is the center of the world.
Bertrand Russell	Do not fear to be eccentric in opinion, for every opinion now accepted was once eccentric.
Sukant Ratnakar	Do not get obsolete like an old technology, keep innovating yourself.
Anthony T.Hincks	Do not give up on yourself. Leave that for the other people.
Jane Austen	Do not give way to useless alarm; though it is right to be prepared for the worst, there is no occasion to look on it as certain.
Catherine Pulsifer	Do not waste your days. Be one of those people who accomplish more in a week than others do in a year!
Albert Einstein	Do not worry about your difficulties in Mathematics. I can assure you mine are still greater.
Agu	Do the things you were sent here to do effectively.
Roald Dahl	Do you know what breakfast cereal is made of? It's made of all those little curly wooden shavings you find in pencil sharpeners!
Unknown	Do you need space? Join NASA!
John Keats	Do you not see how necessary a world of pains and troubles is to school an intelligence and make it a soul?
Todd Perelmuter	Do you think there are smartphones in the afterlife? Because if not, lots of people are going to be very miserable in heaven.
Noam Chomsky	Do you train for passing tests or do you train for creative inquiry?
Lao Tzu	Do your work, then step back. The only path to serenity.
Stephen Richards	Doing the tough things sets winners apart from losers.
Frank Tyger	Doing what you like is freedom. Liking what you do is happiness.
Lorenzo Dozier	Don't act your role, be yourself.
Izey Victoria Odiase	Don't aim for perfection. Aim for 'better than yesterday'.
Karishma Magvani	Don't ask too much for space. They grow into voids.
LeBron James	Don't be afraid of failure. This is the way to succeed.
Joyce Rachelle	Don't be afraid to make mistakes. But if you do, make new ones. Life is too short to make the wrong choice twice.
Jaachynma N.E. Agu	Don't blow off another's candle for it won't make yours shine brighter.
William Faulkner	Don't bother just to be better than your contemporaries or predecessors. Try to be better than yourself.
Anoir Ou-chad	Don't confuse excitement with happiness. The former is feverish and combustible.The latter is serene and long-lasting.
Dr. Seuss	Don't cry because it's over, smile because it happened.
Henry Ford	Don't find fault, find a remedy; anybody can complain
D.L. Lewis	Don't give up when you're disappointed, good things could still happen.
Joel Osteen	Don't go into the new year holding a grudge from last year. Leave the hurts and disappointments behind.
Marcus Aurelius	Don't go on discussing what a good person should be. Just be one.
Urmila Sahu	Don't just listen understand it.
Wesam Fawzi	Don't just wish for success, earn it!
Kelly Martin	Don't let goal setting become heavy weights. Remain flexible and allow room for intuitive changes.
Dr Roopleen	Don't let mental blocks control you. Set yourself free. Confront your fear and turn the mental blocks into building blocks.
Roy T. Bennett	Don't let the expectations and opinions of other people affect your decisions. It's your life, not theirs.
Ludwig van Beethoven	Don't only practice your art, but force your way into its secrets, for it and knowledge can raise men to the divine.
Michael Phelps	Don't put a limit on anything. The more you dream the farther you get.
Unknown	Don't spell part backwards. It's a trap.
Evanescence	Don't try to fix me, I'm not broken...
Saif Rehman	Don't wait for success to become stronger and confident. Be strong and confident Success will automatically chase you
Clarissa Pinkola Est's	Don't waste your time hating a failure. Failure is a greater teacher than success. Listen, learn, go on.
Roy T. Bennett	Don't waste your time in anger, regrets, worries, and grudges. Life is too short to be unhappy.
Shaun David Hutchinson	Dreams are hopeful because they exist as pure possibility. Unlike memories, which are fossils, long dead and buried deep.
Anthony T. Hincks	Dreams will never let you down. Only you can do that.
Maya Angelou	Each person deserves a day away in which no problems are confronted, no solutions searched for.
Jennifer Ritchie Payette	Early scientists were often ridiculed for their theories. Be open to replacing outdated belief systems with new ones.
Mahatma Gandhi	Earth provides enough to satisfy every man's needs, but not every man's greed.
Mark Twain	Eat alive frog first thing in teh mourning and nothing worst will happne to you teh wrest of the day.
Dave Barry	Eating rice cakes is like chewing on a foam coffee cup, only less filling.
Alexander Graham Bell	Educate the masses, elevate their standard of intelligence, and you will certainly have a successful nation.
J. Earp	Education consists primarily in perfecting the art/science of connecting apparently disparate dots.
Daniel M. Greenberger	Einstein said that if quantum mechanics were correct then the world would be crazy. Einstein was right - the world is crazy.
Avina Celeste	Encourage your own greatness.
	Engenuity cap chored arial photographs of teh reked remains of its landign kraft on teh sir face of Mars
Thomas Tredgold	Engineering is the art of directing the great sources of power in nature for the use and convenience of man.
Toba Beta	Enough talk, now read!
Seneca c.4 B.C.-A.D. 65	Eternal law has arranged nothing better than this, that it has given us one way in to life, but many ways out.
Stephen Hawking	Eternity is a long time, especially towards the end.
Old Testament	Even a child is known by his doings.
Mokokoma Mokhonoana	Even a trillion dollars is made up of cents.
Sara Gruen	Even as your body betrays you, your mind denies it.
Hockson Floin	Even during a mid-life crisis do not deviate from your goal. History remembers only those who succeed.
Steven Magee	Even if ninety-nine percent of what you discover is later proven wrong, it is the one percent that is right that matters.
Stanley Victor Paskavich	Even in the fiercest battles the Butterflies and Bee's still kiss the flowers.
Rick Riordan	Even strength must bow to wisdom sometimes.
Nina Dobrev	Even though you're growing up, you should never stop having fun.
Nina Guilbeau	Even when we do not actively participate in our destiny, we are still on a chosen path. Life has a way of making decisions for us.
Hafez	Ever since happiness heard your name, it has been running through the streets trying to find you.
Albert Camus	Every achievement is a servitude. It compels us to a higher achievement.
Abraham Lincoln	Every blade of grass is a study; and to produce two, where there was but one, is both a profit and a pleasure.
Robert Orben	Every day I get up and look through the Forbes list of the richest people in America. If I'm not there, I go to work.
Avina Celeste	Every detour puts you on the right path for your own success.
Aldous Huxley	Every discovery in pure science is potentially subversive.
Philemon	Every gift, though small, is in reality great, if it be given with affection.
Isaac Asimov	Every hour a scientist spends trying to raise funds is an hour lost from important thought and research.
Terry Pratchett	Every intelligent being, whether it breathes or not, coughs nervously at some time in its life.
	Every man has a right to life. That means that he also has a right to make a comfortable living.
Thomas Merton	Every moment and every event of every man's life on earth plants something in his soul.
Walt Whitman	Every moment of light and dark is a miracle.
Tamora Pierce	Every now and then I like to do as I'm told, just to confuse people.
Will Durant	Every science begins as philosophy and ends as art; it arises in hypothesis and flows into achievement.
Ehsan Sehgal	Every success, whether it is the biggest or the smallest, inspires the joy and the beauty of life.
Isaac Asimov	Every thing a bout my crow scopic life is terra plea upsetting. How can things sew small bee sew important?
Steve Backley	Every time a champion makes a decision they have a chance to learn something new, regardless of the outcome.
	Every year it takes less time to fly across the Atlantic and more time to drive to the office.
Dr. Sara Jordan	Everyday, give yourself a good mental shampoo.
	Everyone has his faults which he continually repeats: neither fear nor shame can cure them.
Georg Lichtenberg	Everyone is a genius at least once a year; a real genius has his original ideas closer together.
Isaac Asimov	Everything about microscopic life is terribly upsetting. How can things so small be so important?
Tapan Ghosh	Everything else in life can be confusing but what is clear is the importance of looking after yourself.
Bertrand Russell	Everything is vague to a degree you do not realize till you have tried to make it precise.
James Gleick	Everything we care about lies somewhere in the middle, where pattern and randomness interlace.
FROM THE LATIN	Evil thoughts intrude in an unemployed mind, as naturally as worms are generated in a stagnant pool.
Charles Caleb Colton	Examinations are formidable even to the best prepared, for the greatest fool may ask more than the wisest man can answer.
Les Brown	Except responsibility four you're life. No that it is ewe who will get ewe wear ewe wont two go, know won else.
Stephanie Lahart	Excuse Me While I Succeed!
Eoin Colfer	Excuse me, Captain. Are you two going to weep salty tears of admiration over a helmet all night, or do we have matters to discuss?
Unknown	Experience is what you get when you didn't get what you wanted.
Dr. Dragos	Expressing authentic appreciation doesn't cost you anything and the outcomes are simply wonderful.
Elizabeth Taylor	Eye feal very adventuruos.  Their are sew many doors to be opended, and I'm not afriad to look behidn them.
Kurt Vonnegut	Eye had know talent four science. What was infinitely worse: awl my fraternity brothers whir engineers.
Gurjeet Singh	Eye lived inn fear that other engineers wood stop me inn the street and ask me a math question, and eye wouldn't no the answer.
Unknown	Eye recently heared about a manakin that lost all of his freinds becuse he was so clothes minderd!
David Sedaris	Faced with an exciting question, science tended to provide the dullest possible answer.
Isaac Asimov	Facts are a heap of bricks and timber. It is only a successful theory that can convert the heap into a stately mansion
Dune House Harkonnen.	Facts mean nothing when they are preempted by appearance. Do not underestimate the power of impression over reality.
Brian Howard	Failure has its successes.
Idowu Koyenikan	Failure is constructive feedback that tells you to try a different approach to accomplish what you want.
Truman Capote	Failure is the condiment that gives success its flavor.
Claudia Gray	Faith and mathematics don't only bring you back to the people you love. They can also bring you to the people you hate.
De philosopher DJ Kyos	Fake life is expensive.
Dr. Seuss	Fantasy is a necessary ingredient in living, it's a way of looking at life through the wrong end of a telescope.
Ralph Waldo Emerson	Fear defeats more people than any other one thing in the world.
Bertrand Russell	Fear is the main source of superstition, and one of the main sources of cruelty. To conquer fear is the beginning of wisdom.
Simone Elkeles	Fifty percent of all doctors graduate in the bottom half of their class - Hope your surgery went well!
Miguel de Cervantes Saavedra	Finally, from so little sleeping and so much reading, his brain dried up and he went completely out of his mind.
Amy Poehler	Find a group of people who challenge and inspire you; spend a lot of time with them, and it will change your life.
Criss Jami	Find a purpose to serve, not a lifestyle to live.
Martin Luther King Jr.	Find a voice in a whisper.
Hamzah Hilam	Find as much knowledge as you can. do not forget to share the knowledge that has been obtained to others
Roy T. Bennett	Finding the lesson behind every adversity will be the one important thing that helps get you through it.
Luther Burbank	Flowers always make people better, happier, and more helpful; they are sunshine, food and medicine to the mind.
Roy T. Bennett	Focus on making choices to lead your life that aligns with your core values in the most purposeful way possible.
Anthony T.Hincks	For each answer in life there are ten more questions that need answering.
Robert M. Pirsig	For every fact there is an infinity of hypotheses.
Benjamin Franklin	For every minute spent organizing, an hour is earned.
Irenaeus of Lyons	For it is not needful, to use a common proverb, that one should drink up the ocean who wishes to learn that its water is salt.
Oliver Edwards	For my part now, I consider supper as a turnpike through which one must pass, in order to get to bed.
Unknown	For sale: Watch with half a face. For a limited time only.
Virgil	Fortune assists the bold.
Beth Kempton	Freedom is found within, in the shape of our laughter and the way we love, in the truths that we live by and the stories we become
Epictetus	Freedom is the only worthy goal in life. It is won by disregarding things that lie beyond our control.
Beth Kempton	Freedom is the willingness and ability to choose your own path and experience your life as your true self.
unknown	Freinds come and go, lkie teh wayvs of teh oshun, but teh tru ones stay, lkie an octopous on you're face.
Eleanor Roosevelt	Friendship with oneself is all important, because without it one cannot be friends with anyone else in the world.
Aeschylus	From a small seed a mighty trunk may grow.
Ken Fite	From an early age, our mothers teach us to be thankful.
Groucho Marx	From the moment I picked up your book until I put it down, I was convulsed with laughter. Some day I intend reading it.
TALFOURD	Gentleman is a term which does not apply to any station, but to the mind and the feelings in every station.
Sunday Adelaja	Getting to know who you are is the secret to ensuring that your life will not be dull and unnoticed
Confucius	Give a bowl of rice to a man and you will feed him for a day. Teach him how to grow his own rice and you will save his life.
Pablo Picasso	Give me a museum and I'll fill it.
John Milton	Give me the liberty to know, to utter, and to argue freely according to conscience, above all liberties.
Marquis Pierre Simon de Laplace	Give me the positions and velocities of all the particles in the universe, and I will predict the future.
Demi Lovato	Go ahead and believe that no one shines brighter than you. Become amazing, and be happy.
Zig Ziglar	Go as far as you can see and you will see further.
Mitch Albom	Going back to something is harder than you think.
	Going to church doesn't make you a Christian any more than going to the garage makes you a car.
Donny Ingram	Good advice for anyone wanting to make an impact with a product, a service or even a message is to differentiate yourself.
Irish Prayer	Grant me a sense of humor, Lord, the saving grace to see a joke, to win some happiness from life, and pass it on to other folks.
MELODY BEATTIE	Gratitude makes sense of our past, brings peace for today, and creates a vision for tomorrow.
Michael Hirsch	Gravity always wins
GAMBETTA	Great ability without discretion comes almost invariably to a tragic end.
Napoleon Hill	Great achievement is usually born of great sacrifice, and is never the result of selfishness.
Roy T. Bennett	Great leaders create more leaders, not followers.
Henry Ward Beecher.	Great powers and natural gifts do not bring privileges to their possessor, so much as they bring duties.
	Great things are done when men and mountains meet. This is not done by jostling in the street.
Virginia Woolf	Growing up is losing some illusions, in order to acquire others.
Andrena Sawyer	Guard your heart, mind and time. Those three things will determine the health of everything else in your life.
WELLINGTON	Habit is ten times nature.
Debasish Mridha	Hapliness will grow if ewe plant teh seeds of luv in teh garden of hope with compassoin and kare.
Viktor E. Frankl	Happiness cannot be pursued; it must ensue.
Marguerite Gardiner	Happiness consists not in having much, but in being content with little.
Tom Magliozzi	Happiness equals reality minus expectations.
Aeschylus	Happiness is a choice that requires effort at times.
Steve Maraboli	Happiness is a state of mind, a choice, a way of living; it is not something to be achieved, it is something to be experienced.
Maria von Heland	Happiness is answering your calling.
Rahul Shrivastava	Happiness is standalone element. It's not connected to anything. Least of all to power, wealth, fame or material objects.
Mahatma Gandhi	Happiness is when what you think, what you say, and what you so are in harmony.
Lailah Gifty Akita	Happiness lies in hope.
unknown	Happy is as happy does.
Margaret Mitchell	Hardships make or break people.
JOHN TASKINSOY	Having fun at what you do for work is going to substantially increase the possibility of you becoming successful.
Benjamin Franklin	He who can have patience can have what he will.
Friedrich Nietzsche	He who has a why to live for can bear almost any how.
HABBINGTON	He who is good is happy.
Stephen King	He who speaks without an attentive ear is mute.
Earl of Clarendon	He will be looked upon by posterity as a brave bad man.
Roy T. Bennett	Help others without any reason and give without the expectation of receiving anything in return.
Anders Indset	Helpfulness is the enemy of greed
Jason Mraz	Heres to freedom, cheers to art. Heres to having an excellent adventure and may the stopping never start.
Thomas Babington Macaulay	His imagination resembled the wings of an ostrich. It enabled him to run, though not to soar.
Anonymous	History doesn't repeat itself, it just stutters.
Thomas Carlyle	History is a great dust heap.
Ted Koppel	History is a tool used by politicians to justify their intentions.
Lawrence Goldstone	History is an ocean that books help us to navigate.
Voltaire	History is filled with the sound of silken slippers going downstairs and wooden shoes coming up.
Frederick Maurice Powicke	History is full of the dead weight of things which have escaped the control of the mind, yet drive man on with a blind force.
Jacob Burckhardt	History is the record of what one age finds worthy of note in another.
Author Unknown	History teaches us the mistakes we are going to make.
	History tells us who accomplished great feats, with studious research can we discover their motivation.
Vaclav Havel	Hope is not a feeling of certainty that everything ends well. Hope is just a feeling that life and work have a meaning.
Lisa Scottoline	How do you tell the psychiatrists from the patients in the hospital? The patients get better and leave.
Debasish Mridha, M.D.	How far you will go is defined by your attitude and enthusiasm.
Gail Carriger	How ghastly for her, people actually thinking, with their brains, and right next door. Oh, the travesty of it all.
Anne O'Brien	How grief and the passage of years can leave their mark. How the burden of duty can wear away the body's resilience
Mehmet Murat ildan	How important things you will achieve in life will be determined by how many times you shall act bravely in life!
Felix Long	How is something authorised as 'feng shui compliant' he wondered. Is there a Chinese Ministry of Magic?
Unknown	How many golfers does it take to change a light bulb? FORE!
Craig Thompson	How satisfying it is to leave a mark on a blank surface. To make a map of my movement - no matter how temporary.
Anne Frank	How wonderful it is that nobody need wait a single moment before starting to improve the world.
Stephen Hawking	However bad life may seem, there is always something you can do and succeed at. Where there's life, there's hope.
Stephen Richards	Human beings are incredibly slow, Cosmic Ordering is incredibly fast!
Isaac Asimov	Human beings can easily destroy every elephant on earth, but we are helpless against the mosquito.
	Humanity is never so beautiful as when praying for forgiveness, or else forgiving another.
T.S. Eliot	Humor is also a way of saying something serious.
	Hurdles can be leapt over or plowed through.  Rarely does one deploy monster trucks for the task.
Oscar Wilde	I always pass on good advice. It is the only thing to do with it. It is never of any use to oneself.
Diana Wynne Jones	I am a believer in free will. If my dog chooses to hate the whole human race except myself, it must be free to do so.
Enola Holmes	I am a detective, I am a decipherer, and I am a finder of lost souls. My life is my own. And the future is up to us.
Terry Pratchett	I am a great fan of science, but I cannot do a quadratic equation.
Qamar Rafiq	I am a rusty machine with weary parts in search of my inventor.
	I am always sorry when any language is lost, because languages are the pedigrees of nations.
Shannon Drake	I am learning, and I believe I shall do quite well.
Gabrielle Aplin	I am never without my lyric book. If anything inspirational happens, I have it there so nothing's forgotten.
Tana French	I am not good at noticing when I'm happy, except in retrospect.
Johann Wolfgang von Goethe	I am not omniscient, but I know a lot.
Nelson Mandela	I am the captain of my soul.
T.H. Huxley	I am too much of a skeptic to deny the possibility of anything.
Garrison Keillor	I believe in looking reality straight in the eye and denying it.
	I believe in the possibility of miracles but more to the point, I believe in our need for them.
Unknow	I bought a book titled "How To Scam People Online" about three months ago... It still hasn't arrived.
Jimmy Dean	I can't change the direction of the wind, but I can adjust my sails to always reach my destination.
Herbert Bayard Swope	I can't give you a sure-fire formula for success, but I can give you a formula for failure: try to please everybody all the time.
Dale Wasserman	I come in a world of iron...to make a world of gold
Patricia Cornwell	I didn't invent forensic science and medicine. I just was one of the first people to recognize how interesting it is.
Osric Chau	I do like alternative rock and rap, but as far as inspirational, then I go full-on orchestra. It fills up your entire being.
Isaac Asimov	I do not fear computers. I fear the lack of them.
Jane Austen	I do not want people to be very agreeable, as it saves me the trouble of liking them a great deal.
Sebastian Vettel	I don't care too much what happened in the past. I prefer to focus on what is coming next and I am really looking forward to it.
Melanie White	I don't eat pumpkin pie. It's made from the guts of jack-o-lanterns, and that's just spooky.
Katherine Cebrian	I don't even butter my bread; I consider that cooking.
Dorothy Parker	I don't know much about being a millionaire, but I'll bet I'd be darling at it.
Eoin Colfer	I don't like lollipops.
Paolo Coelho	I don't regret the painful times; I bare my scars as if they were medals.
Emily Dickinson	I dwell in possibility.
Georgette Heyer	I feel an almost overwhelming interest in the methods of daylight abduction employed by the modern youth.
Unknown	I feel like I'm diagonally parked in a parallel universe.
Groucho Marx	I find television very educational. Every time someone turns it on, I go in the other room and read a book.
Steven Magee	I find that a little bit of crazy is an essential ingredient of discovery.
A.P.J. Abdul Kalam	I firmly believe that unless one has tasted the bitter pill of failure, one cannot aspire enough for success.
Abraham Lincoln	I fully appreciate the present peril the country is in, and the weight of responsibility on me.
Unknown	I got a job in a health club, but they said I wasn't fit for the job.
Kurt Vonnegut	I had no talent for science. What was infinitely worse: all my fraternity brothers were engineers.
Edmund Husserl	I had to philosophize. Otherwise, I could not live in this world.
Woody Allen	I hate reality but it's still the best place to get a good steak.
Steven Wright	I have a quantum car. Every time I look at the speedometer I get lost...
Melinda Chapman	I have a shocking memory - I remember everything.
	I have just returned from Boston. It is the only sane thing to do if you find yourself up there.
Albert Einstein	I have no special talents. I am only passionately curious.
Oscar Wilde	I have nothing to declare except my genius.
Sylvia Plath	I have stitched life into me like a rare organ
Oscar Wilde	I have the simplest tastes. I am always satisfied with the best.
Oliver Edwards	I have tried too in my time to be a philosopher; but, I don't know how, cheerfulness was always breaking in.
Abraham Lincoln	I have understood well that the duty of self-preservation rests solely with the American people.
Audrey Hepburn	I heard a definition once: Happiness is health and a short memory! I wish I'd invented it, because it is very true.
Steven Wright	I just got out of the hospital. I was in a speed reading accident. I hit a book mark and flew across the room.
Milton Shulman	I knew a mathematician who said 'I do not know as much as God. But I know as much as God knew at my age'.
Matt Groening	I know all those words, but that sentence makes no sense to me.
Dana Reinhardt	I know certain truths about life.
Socrates 469-399 B.C.	I know nothing except the fact of my ignorance.
Sarah Dessen	I like flaws. I think they make things interesting.
Autre Ne Veut	I like pop music. Earnestly. Most of the greatest technicians, mix engineers, and players are working in pop music.
Unknown	I like to finish other people's sentences because... my version is better.
Bumper sticker.	I like you, but I wouldn't want to see you working with subatomic particles.
Sally Ride	I liked math - that was my favorite subject - and I was very interested in astronomy and in physical science.
Gurjeet Singh	I lived in fear that other engineers would stop me in the street and ask me a math question, and I wouldn't know the answer.
Peter De Vries	I love being a writer. What I can't stand is the paperwork.
	I love the valiant; but it is not enough to wield a broadsword, one must also know against whom.
douglas adams	I may not have gone where I intended to go, but I think I have ended up where I needed to be.
Darynda Jones	I may not look like much, but I'm an expert at pretending to be a ninja.
Mark Twain	I must have a prodigious amount of mind; it takes me as much as a week, sometimes, to make it up!
Calvin Trillin	I never did very well in math - I could never seem to persuade the teacher that I hadn't meant my answers literally.
Prince Philip	I never see any home cooking. All I get is fancy stuff.
Albert Einstein	I never think of the future - it comes soon enough.
Oscar Wilde	I never travel without my diary. One should always have something sensational to read in the train.
Nicolaus Copernicus	I often considered whether there could perhaps be found a more reasonable arrangement of circles.
Socrates	I only know that I know nothing
Dodie Smith	I only want to write. And there's no college for that except life.
Jen Hatmaker	I pray for your kindness more than your success, because the latter without the former is a tragedy.
Steven Wright	I put tape on the mirrors in my house so I don't accidentally walk through into another dimension.
Jon Krakauer	I read somewhere... how important it is in life not necessarily to be strong, but to feel strong... to measure yourself at least once.
Taylor Swift	I rode an elevator with a guy who was whistling the tune of 'this is the song that never ends'. Putting that on me? Come on dude..
Lily Tomlin	I said "Somebody should do something about that." Then I realized I am somebody.
Denzel Washington	I say luck is when an opportunity comes along and you're prepared for it.
Albert Einstein	I speak to everyone in the same way, whether he is the garbage man or the president of the university.
A Bit of Fry and Laurie	I think animal testing is a terrible idea; they get all nervous and give the wrong answers.
Colin Morgan	I think anyone who has a passion for what they love to do, and who pursue it, is inspirational for me.
Charles Schultz	I think I've discovered the secret of life -- you just hang around until you get used to it.
Bruno Mars	I think that success is having fun.
Carl Sagan	I think the discomfort that some people feel in going to the monkey cages at the zoo is a warning sign.
Criss Jami	I think there is a song out there to describe just about any situation.
Unknown	I think therefore I can't get anything done.
	I think with the Romans, that the general of today should be a soldier tomorrow if necessary.
Unknown	I used some magic to make some fog laugh. It was mist tickle.
Unknown	I used to build stairs for a living, it's an up and down business.
Sally Ride	I was always very interested in science, and I knew that for me, science was a better long-term career than tennis.
Jack Kerouac	I was halfway across America, at the dividing line between the East of my youth and the West of my future.
A.P.J. Abdul Kalam	I was willing to accept what I couldn't change.
Mark Twain	I wish I could make him understand that a loving good heart is riches enough, and that without it intellect is poverty.
Bill Watterson	I wonder if you can refuse to inherit the world.
Antoine de Saint-Exupéry	I wonder, he said, whether the stars are set alight in heaven so that one day each one of us may find his own again...
Art Buchwald	I worship the quicksand he walks in.
Abraham Lincoln	I would like to speak in terms of praise due to the many brave officers and soldiers who have fought in the cause of the war.
Nicholas Sparks	I'd learned that some things are best kept secret.
John Maynard Keynes	Ideas shape the course of history.
Isaac Asimov	If a conclusion is not poetically balanced, it cannot be scientifically true.
Sunday Adelaja	If a person is not free, his right is restricted.
Jesse Andrews	If after reading this book you come to my home and brutally murder me, I do not blame you.
Rob Liano	If all the world's a stage, I suggest you start performing at your best.
David Brent	If at first you don't succeed, remove all evidence you ever tried.
Brian Vaszily	If being happy is important to you, try this: instead of regretting all you lack, celebrate all you've got.
Joyce Rachelle	If difficult times teach us the most important lessons, we should then learn to read difficult books.
Abhijit Naskar	If education were the same as information, the encyclopedias would be the greatest sages in the world.
J. Richard Gott	If ewe see an aunty madder version of yoursefl runnign twoards ewe, think twice befoer embarcing.
Neil deGrasse Tyson	If eye whir ever abducted buy aliens, the first thing eye'd ask is weather they came from a planet wear people also deny science.
Dave Barry	If God had wanted us to be concerned for the plight of the toads, he would have made them cute and furry.
Doris	If I can do it, you can do it. Anybody can.
Mahatma Gandhi	If I have the belief that I can do it, I shall surely acquire the capacity to do it even if I may not have it at the beginning.
- Neil deGrasse Tyson ‏@neiltyson	If I were ever abducted by aliens, the first thing I'd ask is whether they came from a planet where people also deny science.
	If it's a good idea, go ahead and do it. It's much easier to apologize than it is to get permission.
Christina Aguilera	If life is a journey, It can take you anywhere you wanna go.
Suzy Kassem	If life throws you a few bad notes or vibrations, don't let them interrupt or alter your song.
Steve Backley	If obstacles are large, jump higher.
Ian Stewart	If our brains were simple enough for us to understand them, we'd be so simple that we couldn't.
Stephen Colbert	If our Founding Fathers wanted us to care about the rest of the world, they wouldn't have declared their independence from it.
Albert Einstein	If people are good only because they fear punishment, and hope for reward, then we are a sorry lot indeed.
John von Neumann	If people do not believe that mathematics is simple, it is only because they do not realize how complicated life is.
	If people learn something about the news by watching the show, that is incidental to my goal.
Rick Riordan	If possible, try to avoid pushing each other over the edge, as that would cause me extra paperwork.
	If the aborigine drafted an IQ test, all of Western civilization would presumably flunk it.
Peter Ustinov	If the world should blow itself up, the last audible voice would be that of an expert saying it can't be done.
Johannes Brahms	If there is anyone here whom I have not insulted, I beg his pardon.
Ross Turner	If there was one advantage of the numerous lifetimes he'd been forced to endure, it was undoubtedly knowledge.
A. Bondoux	If there was one thing that life has taught me, it's to accept the most foolish and unthinkable happiness.
JOHN TASKINSOY	If there were formula for success, mathematicians would have definitely held the top spot in the world's richest list.
Edgar W. Howe	If there were no schools to take the children away from home part of the time, the insane asylums would be filled with mothers.
- Jake Vig ?@Jake_Vig	If there's a better way of showing thanks than eating a large bird followed by pie, I'd like to see it.
Atom Tate	If Time travel were possible, the future would have already taught the present to teach the past how to do it.
Thomas A. Edison	If we all did the things we are really capable of doing, we would literally astound ourselves.
	If we had no faults of our own, we should not take so much pleasure in noticing those in others.
Lailah Gifty Akita	If we listen, we shall learn.
Rand Miller	If you act for self-gain then no good can come of it. If you act selflessly, then you act well for all and you must not be afraid.
Gene Stratton-Porter	If you are lazy, and accept your lot, you may live in it. If you are willing to work, you can write your name anywhere you choose.
Jim Rohn	If you are not willing to risk the usual you will have to settle for the ordinary.
Wayne Dyer	If you blame others for something that happens in your life, then you must wait until they change in order to get better.
Eraldo Banovac	If you cannot solve a problem, ask someone who knows.
Sophie Kinsella	If you can't be honest with your friends and colleagues and loved ones, then what is life all about?
Bill Watterson	If you can't win by reason, go for volume.
Tony Robbins	If you do what you've always done, you'll get what you've always gotten.
Bogdan Vaida	If you don't keep track of great ideas, you'll stop noticing you have them.
Sonali Sinha	If you don't know where you are going, you will never get there.
unknown	If you don't laugh, you'll cry.
Dolly Parton	If you don't like the road you're walking, start paving another one.
Arthur R Marshall	If you don't synthesize knowledge, scientific journals become spare-parts catalogues for machines that are never built.
Mo Willems	If you ever find yourself in the wrong story, leave.
JOHN TASKINSOY	If you feel inferior all the time, this means that you regularly let people say and do to you whatever they feel like.
	If you follow reason far enough it always leads to conclusions that are contrary to reason.
Savas Dimopoulos	If you formulate your question properly, mathematics gives you the answer
Awolumate Samuel	If you go out without a plan, you will return home without any achievement.
Steve Maraboli	If you hang out with chickens, you're going to cluck and if you hang out with eagles, you're going to fly.
Marcus Tullius Cicero	If you have a garden and a library, you have everything you need.
	If you haven't had at least a slight poetic crack in the heart, you have been cheated by nature.
	If you knew that hope and despair were paths to the same destination, which would you choose?
Catherine Pulsifer	If you learned one new thing every day imagine what you would have learned in a year.
Lailah Gifty Akita	If you read good books, you will be well-informed.
	If you really love, if you really know how to laugh, the result is the same - you forget yourself.
James A. Michener	If you reject the food, ignore the customs, fear the religion, and avoid the people, you might better stay home.
Neil deGrasse Tyson	If you removed all the arteries, veins, & capillaries from a person's body, and tied them end-to-end…the person will die.
	If you surrender completely to the moments as they pass, you live more richly those moments.
Toni Morrison	If you surrendered to the air, you could ride it.
Ibrahim Mustapha	If you think of building your life the way you build a house, it can help you see how important having a strong foundation is
Olin Miller.	If you think there are no new frontiers, watch a boy ring the front doorbell on his first date.
Amit Ray	If you think world is a fun, a magic, a mystery, world will bring fun and mysteries for you.
Tolstoy Leo	If you want to be happy, be.
Steve Maraboli	If you want to find happiness, find gratitude.
Tommy Newberry	If you want to lead an extraordinary life, find out what the ordinary do–and don't do it.
unknown	If you want to succeed in anything you do, you have to find some fun in it.
Rajesh Walecha	If you're looking at the watch while working,better take rest.
Chad Sugg	If you're reading this… Congratulations, you're alive. If that's not something to smile about, then I don't know what is.
Mae West	I'll try anything once, twice if I like it, three times to make sure.
Tendai Chitewere	I'm a mathematical optimist: I deal only with positive integers.
Antonio Gramsci	I'm a pessimist because of intelligence, but an optimist because of will.
Unknown	I'm in the mood to multiply
Sanita Belgrave	Im learning more that some of life lessons are well hidden, but Im reporting today to SEEK the value of the unwritten.
Graham Parke	I'm looking into my past lives. I'm convinced some of them still owe me money.
A. Whitney Brown	I'm not a vegetarian because I love animals, I'm a vegetarian because I hate plants.
George Lucas	I'm not much of a math and science guy. I spent most of my time in school daydreaming and managed to turn it into a living.
Maya Banks	I'm not stubborn. My way is just better.
DeWayne Owens	I'm so optimistic my blood type is B Positive
Cassandra Clare	I'm sorry. I use my rapier wit to hide my inner pain.
Ellen DeGeneres	I'm thankful for each and every one of you. Now stop hiding in the broom closet reading tweets and get back with your family.
Steven Wright	I'm writing a book. I've got the page numbers done.
Francis Bacon	Imagination was given to man to compensate him for what he is not; a sense of humor to console him for what he is.
John Green	Imagine others complexly.
Fred Allen	Imitation is the sincerest form of television.
1 Thessalonians 5:18	In all things give thanks.
Tarun Sharma	In chaos is where learning happens the most.
Avi	In elementary school, I did well in science, but I was a poor writer. When I got to high school, I failed all my courses.
	In every profession the daily and common duties are the most useful.
Beth Kempton	In finding the courage and confidence to escape our cages and shine, we help others do the same.
Matthew Tysz	In life, there is no lesson greater than patience; and so, there is no teacher greater than a fool.
ROBERT HALL	In madders of cnoscience first thouhgts are bets, in madders of prudnece last thoughst aer bset.
A2K	In order to fail, you must try first.
unknown	In recalling their school years, students mostly remember their teachers, and not the courses they took.
Steven Wright	In school they told me Practice makes perfect. And then they told me Nobody's perfect, so then I stopped practicing.
Bruce Cockburn	In the absence of vision, there are nightmares.
Jim Butcher	In the action business, when you don't want to say you ran like a mouse, you call it 'taking cover.' It's more heroic.
Chris Chambers	In the battle between science and storytelling, there is simply no competition: storytelling wins every time.
Stanley Victor Paskavich	In the beginning the Poets and Philosophers taught the world to see. Then after that any form of education was no longer free.
Nicholas Sparks	In the end you should always do the right thing even if it's hard.
	In the hearts and minds of the people, the grapes of wrath were growing heavy for the vintage.
Terry Pratchett	In theory it was, around now, Literature. Susan hated Literature. She'd much prefer to read a good book.
Philemon	In this thing one man is superior to another, that he is better able to bear adversity and prosperity.
George Clason	In those things toward which we exerted our best endeavors we succeeded.
Robert Frost	In three words I can sum up everything I've learned about life: it goes on.
Janvier Chouteu-Chando	In today's world, human desires far supersede human needs. Waste, as you can see, is the result of that disparity.
Steve Maraboli	In your own life it's important to know how spectacular you are.
Santhosh Namballa	Inability to deal with a different ideology than one's own is the biggest disability a human can posses.
Sunday Adelaja	Individuals should take personal responsibility for knowledge acquisition and campaigns against ignorance.
Benjamin Franklin	Instead of cursing the darkness, light a candle.
Craig D. Lounsbrough	Intelligence and wisdom are certainly compatible, however they are rarely seen in each other's company.
Unknown	Intelligence is like an underwear. It is important that you have it, but not necessary that you show it off.
Steve Backley	Invest your energy in the things you can control.
Ahmed Zewail	Investing in science education and curiosity-driven research is investing in the future.
	Is it better to be the lover or the loved one? Neither, if your cholesterol is over six hundred.
Bertrand Russell	Is there any knowledge in the world which is so certain that no reasonable man could doubt it?
Kelvin Throop III	Isn't it interesting that the same people who laugh at science fiction listen to weather forecasts and economists?
Douglas Adams	It can hardly be a coincidence that no language on earth has ever produced the expression, 'As pretty as an airport.
Roy T. Bennett	It doesn't matter how many times you get knocked down. All that matters is you get up one more time than you were knocked down.
Jaachynma N.E. Agu	It doesn't matter how wealthy you may be in material things, what matters is do you know what to do with those wealth?
Dean Graziosi	It doesn't matter where you come from. It only matters where you are and where you want to go.
Bertrand Russell	It has been said that man is a rational animal. All my life I have been searching for evidence which could support this.
Carlyle.	It is a much shallower and more ignoble occupation to detect faults than to discover beauties.
Isaac Asimov	It is a sign of our power, and our criminal folly, that we can pollute the vast ocean and are doing so.
Abhijit Naskar	It is a tragedy of modern life that the light of truth scares the society much more than the darkness of ignorance.
Amelia Barr	It is always the simple that produces the marvelous.
Harry S. Truman	It is amazing what you can accomplish if you do not care who gets the credit.
John Bytheway	It is better to be respected than it is to be popular. Popularity ends on yearbook day, but respect lasts forever.
Theodore Roosevelt	It is hard to fail, but it is worse never to have tried to succeed.
Unknown	It is hard to understand how a cemetery raised its burial cost and blamed it on the cost of living.
Nick Powers	It is impossible to transcend the laws of nature. You can only determine that your understanding of nature has changed.
Anthony Robbins	It is in your moments of decision that your destiny is shaped.
	It is more difficult, and it calls for higher energies of soul, to live a martyr than to die one.
Friedrich Wilhelms Nietzsche	It is nobler to declare oneself wrong than to insist on being right --especially when one is right.
Lailah Gifty Akita	It is not how long the music last but how much we enjoy.
Charles Sprugeon	It is not how much we have, but how much we enjoy that makes happiness.
Samuil Shatunovsky	It is not the job of mathematicians... to do correct arithmetical operations. It is the job of bank accountants.
Edmund Hillary	It is not the mountain we conquer but ourselves.
MARILU HENNER	It is now common knowledge that the average American gains 7 pounds between Thanksgiving and New Year's Day.
Ralph Waldo Emerson	It is one of the beautiful compensations of life that no man can sincerely try to help another without helping himself.
Patricia Briggs	It is one of those lessons that every child should learn: Don't play with fire, sharp objects, or ancient artifacts.
Spencer Johnson	It is safer to search in the maze than to remain in a cheeseless situation
Emile Durkheim	It is science, and not religion, which has taught men that things are complex and difficult to understand.
Georg C. Lichtenberg	It is strange that only extraordinary men make the discoveries, which later appear so easy and simple.
Isaac Asimov	It is strange, but rocks, properly chosen and polished, can be as beautiful as flowers, and much more durable.
	It is the duty of the President to propose and it is the privilege of the Congress to dispose.
Isaac Asimov	It is the easiest thing in the world to deny a fact. People do it all the time. Yet it remains a fact just the same.
FROM THE LATIN	It is the greatest possible praise to be praised by a man who is himself deserving of praise.
Alexander Graham Bell	It is the man who carefully advances step by step...who is bound to succeed in the greatest degree.
	It is the privilege of genius that life never grows commonplace, as it does for the rest of us.
	It is the rare fortune of these days that one may think what one likes and say what one thinks.
Ralph Charell	It is through cooperation, rather than conflict, that your greatest successes will be derived.
Steve Maraboli	It only takes a split second to smile and forget, yet to someone that needed it, it can last a lifetime.
Carl Sagan	It pays to keep an open mind, but not so open your brains fall out.
Oliver Wendell Holmes, Jr.	It seems to me that at this time we need education in the obvious more than investigation of the obscure.
Oliver Wendell Holmes, Jr.	It seems two me that at this thyme wee knead edukashun inn the obvious more than investigation of the obscure.
Anne Morrow Lindbergh	it takes as much courage to have tried and failed as it does to have tried and succeded.
Brandon Sanderson	It was amazing how many books one could fit into a room, assuming one didn't want to move around very much.
Mary Shelley	It was the secrets of heaven and earth that I desired to learn.
Fanny Burney	It's a delightful thing to think of perfection; but it's vastly more amusing to talk of errors and absurdities.
Steve Maraboli	It's a lack of clarity that creates chaos and frustration. Those emotions are poison to any living goal.
Norman Vincent Peale	It's always too soon to quit.
Haruki Murakami	It's easy to forget things you don't need anymore.
Isaac Asimov	It's humbling to think that all animals, including human beings, are parasites of the plant world.
	Its impossible two walk threw solid rock... Ewe halve two walk between the molecules that makeup the rock.
Sara Shepard	Its more fun to think of the future than dwell on the past.
the Oaqui	It's more fun when you're not the only one having it.
Criss Jami	It's much easier on the emotions when one sees life as an experiment rather than a struggle for popularity.
Stephen Chbosky	It's much easier to not know things sometimes. Things change and friends leave. And life doesn't stop for anybody.
George Eliot	It's never too late to be what you might have been.
Steve Maraboli	It's not always what we don't know that gets in our way; sometimes it's what we think we know that keeps us from learning.
Les Brown	It's not over until you win
Lou Holtz	It's not the load that breaks you down, it's the way you carry it.
Roy T. Bennett	It's only after you've stepped outside your comfort zone that you begin to change, grow, and transform. 
Robyn Mundell	It's pretty confusing.
Richard Feynman	I've always been very one-sided about science, and when I was younger, I concentrated almost all my effort on it.
John Barrowman	I've always thought people would find a lot more pleasure in their routines if they burst into song at significant moments.
Audrey Hepburn	I've been lucky. Opportunities don't often come along. So, when they do, you have to grab them.
	I've been smoking nearly fifty years now. I just don't feel safe breathing anything I can't see!
Simon and Garfunkel	I've got nothing to do today but smile.
Mark Twain	I've had a lot of worries in my life, most of which never happened.
C Gordon Bell	I've never seen a job being done by a five-hundred-person engineering team that couldn't be done better by fifty people.
Jim Morrison	I've noticed that when people are joking they're usually dead serious, and when they're serious, they're usually pretty funny.
Dalai Lama XIV	Judge your success by what you had to give up in order to get it.
Vineet Raj Kapoor	Just a grain can bring a bird down from the skies.
Frederico Rochaferreira	Just as graphite and diamonds have the same composition, that which seems quite obvious, may also not be
Taylor Swift	Just be yourself, there is no one better.
Hans Christian Anderson	Just living is not enough," said the butterfly, "one must have sunshine, freedom, and a little flower.
Susan Vreeland	Just think. We're whizzing through the universe.
Genereux Philip	Keep away from the kinship of the individuals who continually ask and examine the imperfections of others.
Cookie Monster	Keep calm and eat cookies.
Roy T. Bennett	Keep your promises and be consistent. Be the kind of person others can trust.
John Green	Keeping the box closed just keeps you in the dark, not the universe... but failing to open the box doesn't kill the cat.
Neil Harbisson	Kids are really inspired to not just apply senses to robots and machines, but to try them on themselves.
George H. W. Bush	Know what you're talking about.
Suzanne Collins	Knowing it and seeing it are two different things.
ThÃ©un Mares	KNOWLEDGE CAN BE ACQUIRED ONLY THROUGH ACTION IN DAILY LIFE.
Rajen Jani	Knowledge if churned like milk, results in the butter of wisdom.
Ludwig Wittgenstein	Knowledge is in the end based on acknowledgement.
Samuel Johnson	Knowledge is more than equivalent to force.
RUFUS CHOATE	Knowledge is power as well as fame.
Lailah Gifty Akita	Knowledge is strength.
	Knowledge must come through action - you can have no test which is not fanciful, save by trial.
Chris Grabenstein	Knowledge not shared remains unknown
Sunday Adelaja	Knowledge will help you to solve any problem
J. P. Vaswani	Knowledge without action is empty as a shadow.
Toni Sorenson	Lace up those shoes, breathe deep, and get out there. You've got miracles to make happen today.
Jim Butcher	Laughter is good for you. Nine out of ten stand-up comedians recommend laughter in the face of intense stupidity.
Wayne Chirisa	Leaders cannot build a successful nation once they are yoked to these two evils, ignorance and greed.
Rajen Jani	Leaders prioritize what they want.
Lolly Daskal	Leadership is developed daily, not in a day.
Dwight Eisenhower	Leadership is the art of getting someone else to do something you want done because he wants to do it.
Sarah Caldwell	Learn everything you can, anytime you can, from anyone you can, there will always come a time when you will be grateful you did.
James Ryan	Learn to live with less so that you appreciate more.
Roy T. Bennett	Learning to distance yourself from all the negativity is one of the greatest lessons to achieve inner peace.
Aquib Ali	Leave stories behind that add to hopes of generations to come.
Ben Shneiderman	Leonardo Da Vinci combined art and science and aesthetics and engineering, that kind of unity is needed once again.
Ralph Waldo Emerson	Let me never fall into the vulgar mistake of dreaming that I am persecuted whenever I am contradicted.
CORNEILLE	Let us attend to the present, and as to the future we shall know how to manage when the occasion arrives.
LOWELL	Let us be of good cheer, remembering that the misfortunes hardest to bear are those which never happen.
Abraham Lincoln	Let us then turn this government back into the channel in which the framers of the Constitution originally placed it.
unknown	Let's get things straight.
Søren Kierkegaard	Life can only be understood backwards; but it must be lived forwards.
Mohammed Sekouty	Life can't break me, I'm built to be shocks absorber
Florida Scott-Maxwell	Life does not accommodate you; it shatters you. Every seed destroys its container, or else there would be no fruition.
Haruki Murakami	Life doesn't require ideals. It requires standards of action.
AAAA	Life doesn't start at some magical point in the future.
Avijeet Das	Life gives us problems not to break us but to test our strength!
E.A. Bucchianeri	Life has a cruel way of reminding one and all it stops for no one and simply marches on, dragging everyone with it.
Cassandra Clare	Life is a book and there are a thousand pages I have not yet read.
Sukant Ratnakar	life is a continous journey of transformation
Diva Jefferson	Life is a journey worth making.
Jim Butcher	Life is a journey. Time is a river. The door is ajar
Janvier Chouteu-Chando	Life is a mighty joke that is not meant to be funny.
Roy T. Bennett	Life is about accepting the challenges along the way, choosing to keep moving forward, and savoring the journey.
Stewart Stafford	Life is an endless trial and death its certain verdict, but there are many recesses to enjoy before then.
Helen Keller	Life is either daring adventure or nothing.
Hemant Pandey	Life is essentially a circus and we are just playing our roles. Remember life makes everyone 'joker' once in a while.
Maya Angelou	Life is going to give you just what you put in it. Put your whole heart in everything you do, and pray, then you can wait.
Tapan Ghosh	Life is just a game of Snakes and Ladders. Learn to befriend the snakes.
Winston Groom	Life is like a box of chocolates.
sidney sheldon	Life is like a novel. It's filled with suspense. You have no idea what is going to happen until you turn the page.
Kellie Elmore	Life is like a steering wheel, it only takes one small move to change your entire direction.
Roald Dahl	Life is more fun if you play games.
Haruki Murakami	Life is not like water. Things in life don't necessarily flow over the shortest possible route.
Roy T. Bennett	Life is short. Focus on what really matters most. You have to change your priorities over time.
Ralph Ellison	Life is to be lived, not controlled; and humanity is won by continuing to play in face of certain defeat.
Akansh Malik	Life is too short to repeat your mistakes, make new ones..!!
John Lennon	Life is very short, and there's no time for fussing and fighting my friends
Jane Austen	Life seems but a quick succession of busy nothings.
E.M. Forster	Life' wrote a friend of mine, 'is a public performance on the violin, in which you must learn the instrument as you go along.
Jim Henson	Life's like a movie, write your own ending. Keep believing, keep pretending.
Brent M. Jones	Life's trail can double back and retrace it's path several times but when it does you learn more. What is the same is also different.
Aaron Lauritsen	Life's trials will test you, and shape you, but dont let them change who you are.
Rajesh Walecha	Lift your morals high to fight the trap of gravity.
Sunday Adelaja	Light generates life and causes it to grow.
Gillian Duce	Light your life with purpose and all shadows will disappear.
James Mark Baldwin	Like all science, psychology is knowledge; and like science again, it is knowledge of a definite thing, the mind.
Louise Blackwick	Listen to me, dear. When life hands you something, you take it, for in all likelihood, there's a large crisis heading your way.
Unknown	Lite travles faster then sound.  This is why some poeple appeer brite until you here them speek.
Steve Maraboli	Live authentically. Why would you continue to compromise something that's beautiful to create something that is fake?
Christopher Paolini	Live in the present, remember the past, and fear not the future, for it doesn't exist and never shall. There is only now.
Henry David Thoreau	Live your beliefs and you can turn the world around.
Musa M.	living is more than just a pulse
Montaigne (Michel Eyquem de Montaigne)	Living is my job and my art.
Draya Mooney	Look at the stars. See their beauty. And in that beauty, see yourself.
	Lord, where we are wrong, make us willing to change; where we are right, make us easy to live with.
Yogi Berra	Losing is a learning experience. It teaches you humility. It teaches you to work harder. It's also a powerful motivator.
Jo Nesbo	Losing your life is not the worst thing that can happen. The worst thing is to lose your reason for living.
Dalai Lama XIV	Love is the absence of judgment.
Nico J. Genes	Love is the color in your life. Enjoy all the shades and new sensations that come with it, making you feel alive.
Brian Tracy	Love only grows by sharing. You can only have more for yourself by giving it away to others.
Steve Maraboli	Love yourself. Forgive yourself. Be true to yourself. How you treat yourself sets the standard for how others will treat you.
Tennessee Williams	Luck is believing you're lucky.
Arthur C. Clarke	Magic's just science that we don't understand yet.
Lailah Gifty Akita	Make plans for your new goals. And press towards achieving the goals with all your strength.
Sunday Adelaja	Make sure you are standing for something you believe in.
Zig Ziglar	Make today worth remembering.
Avina Celeste	Make your success a habit not just an act of whim.
Maria von Heland	Making comparisons can spoil your happiness.
Ludwig Wittgenstein	Man has to awaken to wonder - and so perhaps do peoples. Science is a way of sending him to sleep again.
Benjamin Franklin	Man is a tool-making animal.
Winston Churchill	Man will occasionally stumble over the truth, but most of the time he will pick himself up and continue on.
	Man, I was tame compared to what they do now, are you kidding? All that I ever did was just jiggle.
Thomas Edison	Many of life's failures are people who did not realise how close they were to success when they gave up.
Mia Hamm	Many people say I'm the best women's soccer player in the world. I don't think so. And because of that, someday I just might be.
	Many plays, are like blank checks. The actors and directors put their own signatures on them.
Dave Beard	Many years ago I resolved never to bother with New Year's resolutions, and I've stuck with it ever since.
Elon Musk	Mars is the only place in the solar system where it's possible for life to become multi-planetarian.
Unknown	Materialism: buying things we don't need with money we don't have to impress people that don't matter.
Wilfred James Dolor	Math is my Passion. Engineering is my Profession.
Unknown	Math puns are the first sine of madness!
John Arbuthnot	Mathematical Knowledge adds a manly Vigour to the Mind, frees it from Prejudice, Credulity, and Superstition.
Deepak Chopra	Mathematics expresses values that reflect the cosmos, including orderliness, balance, harmony, logic, and abstract beauty.
Plato	Mathematics is like checkers in being suitable for the young, not too difficult, amusing, and without peril to the state.
Abid Hussain Library Officer	May success knock your door always
Anthony T.Hincks	May the knowledge gained in one's lifetime become the new wisdom that will last for a thousand years.
Wendy Mass	Maybe some things aren't meant to be known. maybe there just meant to be accepted.
Alberto Manguel	Maybe this is why we read, and why in moments of darkness we return to books: to find words for what we already know.
James Bryce.	Medicine, the only profession that labors incessantly to destroy the reason for its own existence.
Rosa Parks	Memories of our lives, of our works and our deeds will continue in others.
George Carlin	Meow means woof in cat.
Hillary DePiano	Midnight on New Year's Eve is a unique kind of magic where, just for a moment, the past and the future exist at once in the present.
	Millions of spiritual creatures walk the earth unseen, both when we sleep and when we awake.
Brittany Burgunder	Mindset is everything. Like the eye of a storm -find the sunshine and calm within you, even if there is chaos outside of you.
Jean Cocteau	Mirrors should think longer before they reflect.
	Misspelled Aristocrat: 6th grade or less – 85-95 letters 19 or more unique Chi-Square < 30, K1 Key 9 letters or more.  I usually shoot for something humorous here.
Suzy Kassem	Momentum builds success.
Unknown	Money talks ...but all mine ever says is good-bye.
William Shakespeare	More matter with less art.
Craig D. Lounsbrough	More times than not, going backwards is a necessary part of going forwards.
Marty Rubin	Morning will come, it has no choice.
Thomas More	Most people know nothing about learning; many despise it. Dummies reject as too hard whatever is not dumb.
Bill Gates	Most people overestimate what they can do in one year and underestimate what they can do in ten years.
Albert Einstein	Most people say that it is the intellect which makes a great scientist. They are wrong: it is character.
Larry Niven	Mother Nature doesn't care if you're having fun.
Thomas Wentworth Higginson	Much which we think essential is merely a matter of habit.
Bruno Mars	Music is not math. It's science. You keep mixing the stuff up until it blows up on you, or it becomes this incredible potion.
Amit Kalantri	Music shouldn't be just a tune, it should be a touch.
Nikola Tesla	My belief is firm in a law of compensation. The true rewards are ever in proportion to the labor and sacrifices made.
Unknown	My best mates and I played a game of hiding and seek. It went on for hours... Well, good friends are hard to find.
Unknown	My dad finally left me a voicemail where he didn't introduce himself. I think we're getting closer.
Orson Welles	My doctor told me to stop having intimate dinners for four. Unless there are three other people.
Unknown	My dog and I both freak out whenever the doorbell rings but we run in opposite directions.
Unknown	My favorite part of Fall is walking through a hundred spider webs a day and screaming every single time.
Jack Thorne	My geekness is a-quivering.
Stephen Hawking	My goal is simple. It is a complete understanding of the universe, why it is as it is and why it exists at all.
Haruki Murakami	My grandpa always said asking a question is embarrass for a moment but not asking a question is embarrasing for a life time
Martin Luther	My heart, which is so full to overflowing, has often been solaced and refreshed by music when sick and weary.
	My idea of walking into the jaws of death is marrying some woman who has lost three husbands.
Tiger Woods	My main focus is on my game.
Nora Okja Keller	My mother was like a cat who could never catch the tail of happiness because she never stopped chasing it.
Unknown	My new year's resolution this year is to make a resolution that I can actually keep, like drink a glass of water before bed, tonight.
Tamyara Brown	My novels are written with the purpose of taking all of my character's mess and turning it into a beautiful masterpiece.
Unknown	My prince is not coming on a white horse... He's obviously riding a turtle, and definitely lost.
	My tattooing is indestructible. It is an everlasting gem that you will take into your grave.
Debasish Mridha MD	My technique is my love for my profession. When you love to do something, you do your best.
Neil deGrasse Tyson	My view is that if your philosophy is not unsettled daily then you are blind to all the universe has to offer.
Robert Lanza	Mystery is never disproof.
A.P.J. Abdul Kalam	Nations consist of people. And with their effort, a nation can accomplish all it could ever want.
Sunday Adelaja	Nations that have successfully converted better are those ones we refer to as developed nations today
Bertrand Russell	Neither a man nor a crowd nor a nation can be trusted to act humanely or to think sanely under the influence of a great fear.
Tyler Kent White	Never apologize for burning too brightly or collapsing into yourself every night. That is how galaxies are made.
Marty Rubin	Never confuse a hunger for knowledge with a thirst for truth.
Abhijit Naskar	Never confuse belief with knowledge.
Niels Bohr	Never express yourself more clearly than you are able to think.
Larry Niven	Never fire a laser at a mirror.
Bernard Baruch	Never follow the crowd.
Lailah Gifty Akita	Never forget your past.
H. Jackson Brown Jr.	Never give up on what you really want to do. The person with big dreams is more powerful than one with all the facts.
Debasish Mridha MD	Never give up your desire to be what you want to be. Stay focused, persistent and relentless.
Thomas S. Monson	Never let a problem to be solved, become more important than a person to be loved.
Roy T. Bennett	Never let hard lessons harden your heart; the hard lessons of life are meant to make you better, not bitter.
Henry David Thoreau	Never look back unless you are planning to go that way
Audrey Hepburn	Never regret anything that made you smile.
Bohdi Sanders	Never respond to an angry person with a fiery comeback, even if he deserves it...Don't allow his anger to become your anger.
Benjamin Franklin	Never ruin an apology with an excuse.
Victoria Addino	Never sit back and wait for a opportunity to find you, get up and search for one, it exists find it!
Debasish Mridha, M.D.	Never stop being kind, because everyone deserves it.
Santosh Kalwar	Never stop just because you feel defeated. The journey to the other side is attainable only after great suffering.
Eleanor Brownn	Never take life for granted. Savor every sunrise, because no one is promised tomorrow…or even the rest of today.
Niccolo Machiavelli	Never was anything great achieved without danger.
Lucy Maud Montgomery	Next to trying and winning, the best thing is trying and failing.
Alexander Graham Bell	Night is a more quiet time to work. It aids thought.
Aesop	No act of kindness, no matter how small, is ever wasted.
Stephen Fry	No adolescent ever wants to be understood, which is why they complain about being misunderstood all the time.
Albert Einstein	No amount of experimentation can ever prove me right; a single experiment can prove me wrong.
Lailah Gifty Akita	No experience is wasted. It is the stepping stones for a great success.
Isaac Newton	No great discovery was ever made without a bold guess.
Khalil Gibran	No man can reveal to you aught but that which already lies half asleep in the dawning of your knowledge.
Luis Chaluisan	No masterpiece was ever created by a lazy artist.
	No matter how old a mother is, she watches her middle-aged children for signs of improvement.
Walt Disney Company	No matter how your heart is grieving, if you keep on believing, the dreams that you wish will come true.
Sandy Brewer	No matter what happened yesterday it is insignificant when compared to what lies within the core of your being today.
Emily M. Axelrod	No matter what role you play in a meeting, how you show up in that role is critical to the meeting's success.
Steve Maraboli	No matter what your history has been, your destiny is what you create today. What are you going to create?
Laurell K. Hamilton	No name-calling truly bites deep unless, in some dark part of us, we believe it. If we are confident enough then it is just noise.
	No offense Apu, but when they were handing out religions you must have been out taking a whiz.
Robert J. Sawyer	No one disputes that seeming order can come out of the application of simple rules. But who wrote the rules?
Henry Petroski	No one wants to learn from mistakes, but we cannot learn enough from successes to go beyond the state of the art.
Samuel Johnson	No place affords a more striking conviction of the vanity of human hopes, than a public library.
BACON	No pleasure is comparable to the standing upon the vantage-ground of truth.
Democritus	No power and no treasure can outweigh the extension of our knowledge.
A.P.J. Abdul Kalam	No sanction can stand against ignited minds.
Srinivasa Ramanujan	No, it is a very interesting number, it is the smallest number expressible as a sum of two cubes in two different ways.
William Morris	Not on one strand are all life's jewels strung.
	Nothing can resist the human will that will stake even its existence on its stated purpose.
	Nothing has any power over me other than that which I give it through my conscious thoughts.
BEACONSFIELD	Nothing in life is more remarkable than the unnecessary anxiety which we endure and generally occasion ourselves.
Marie Curie	Nothing in life is to be feared, it is only to be understood. Now is the time to understand more, so that we may fear less.
Howard Nemerov	Nothing in the universe can travel at the speed of light, they say, forgetful of the shadow`s speed.
	Nothing is faster than the speed of light. To prove this to yourself, try opening the refrigerator door before the light comes on.
Amy Chua	Nothing is fun until you're good at it.
A. P. Herbert	Nothing is wasted, nothing is in vain: The seas roll over but the rocks remain.
Robert Greenleaf	Nothing much happens without a dream. For something really great to happen, it takes a really great dream.
Marty Rubin	Nothing succeeds like indifference to success.
Eraldo Banovac	Nowadays, focusing on transferring applicable knowledge is a very challenging task that all teachers face.
	O what fine thought we had because we thought that the worst rogues and rascals had died out.
Henry Ford	Obsticalls aer tohes frightning thinsg that beecmoe vsiible wen we take are eyes off ar goles.
Isaac Asimov	Of all extinct life-forms, dinosaurs are the most popular. Why that should be is not clear.
Nikola Tesla	Of all things, I liked books best.
	Of course there is learning without teaching. It's just commonly referred to by another name: science.
Mark Twain	Often it does seem such a pity that Noah and his party did not miss the boat.
Stephen Wright	OK, so what's the speed of dark ?
Curtis Tyrone Jones	Old lady failure died giving birth to twin giants named confidence & optimism, but her name lives on as the mother of success.
Oscar Wilde	On an occasion of this kind it becomes more than a moral duty to speak one's mind. It becomes a pleasure.
Unknown	On the other hand, you have different fingers.
Richard Feynman	Once I get on a puzzle, I can't get off.
Bhuwan Thapaliya	Once in a while, however, the impossible happens in life. Just hang in there.
Albert Einstein	Once we accept our limits, we go beyond them.
Albert Einstein	Once you can accept the universe as matter expanding into nothing that is something, wearing stripes with plaid comes easy.
Duke Leto Atreides	Once you have explored a fear, it becomes less terrifying. Part of courage comes from extending our knowledge.
J.K. Rowling	One can never have enough socks
Beverly Donofrio	One day can change your life. One day can ruin your life. All life is is three or four big days that change everything.
	One good husband is worth two good wives, for the scarcer things are, the more they are valued.
Antonio Porchia	One lives in the hope of becoming a memory.
Groucho Marx	One morning I shot an elephant in my pajamas. How he got in my pajamas I'll never know.
Kay Redfield Jamison	One of the advantages of science is that one's work, ultimately, is either replicated or it is not.
Roy T. Bennett	One of the best ways to influence people is to make them feel important.
Jimmy Buffett	One of the inescapable encumbrances of leading an interesting life is that there have to be moments when you almost lose it.
Karen Arnold	One of the problems with having time to read all that you want is that your interests become so eclectic it's hard to focus.
Iris Murdoch	One of the secrets of a happy life is continuous small treats.
Brian Greene	One of the wonders of science is that it is completely universal. It crosses national boundaries with total ease.
Jeremy Piven	One person's success doesn't take away from your own.
Edward O. Wilson	One planet, one experiment.
John Burroughs	One resolution I have made, and try always to keep, is this — To rise above the little things.
Abhijit Naskar	One who knows what he or she knows as well as what he or she does not know is a genius.
Roy T. Bennett	One word of encouragement can be enough to spark someone's motivation to continue with a difficult challenge.
Haruki Murakami	Only through knowing could a person become strong.
Chris Grosser	Opportunities don't happen, you create them.
Helen Keller	Optimism is the faith that leads to achievement. Nothing can be done without hope and confidence.
Rousseau Jean-Jacques	Or, rather, let us be more simple and less vain.
Alexander Pope	Order is heaven's first law.
A. A. Milne	Organizing is what you do before you do something, so that when you do it, it is not all mixed up.
Jack Kerouac	Our battered suitcases were piled on the sidewalk again; we had longer ways to go. But no matter, the road is life
Enola	Our future is up to us.
Francis Chan	Our greatest fear should not be of failure but of succeeding at things in life that don't really matter.
Maria Koszler	Our lives are just a journey back to THE LIGHT
Israelmore Ayivor	Our obstacles are tough, so are our potentials. If we don't unleash our potentials, our obstacles will cripple us!
	Our prejudices are like physical infirmities - we cannot do what they prevent us from doing.
Carl Sagan	Our species needs, and deserves, a citizenry with minds wide awake and a basic understanding of how the world works.
Mustafa Kemal Atatürk	Our true mentor in life is science.
Nikola Tesla	Our virtues and our failings are inseparable, like force and matter. When they separate, man is no more
Chaucer	Out of the fullness of the heart, the mouth speaks.
COLTON	Patience is the support of weakness; impatience is the ruin of strength.
Nicky Verd	Pay attention to your calling and the world will pay attention to you
Benjamin Franklin	Pay what you owe and what you're worth you'll know.
Sri Chinmoy	Peace begins when expectations end.
Truth Devour	Peer beyond the wall of doubt to embrace the possibilities.
Lisa Nichols	People are more comfortable with a familiar discomfort than they are with an unfamiliar new possibility.
Jess C. Scott	People are sheep. TV is the shepherd.
Sunday Adelaja	People are successful today because they work hard with an incredible faith in themselves in converting their time
Unknown	People don't get my puns. They think they're funny.
Charles Bukowski	People don't need love. What they need is success in one form or another. It can be love but it needn't be.
Zig Ziglar	People often say that motivation doesn't last. Well, neither does bathing – that's why we recommend it daily.
Retta	People who are going to be successful know it's gonna happen. And those people tend to hustle until it does happen.
	People who cannot recognize a palpable absurdity are very much in the way of civilization.
Jennifer White	People who tell you to stop living in a fairytale world are very likely people who live in a horror movie.
W. Somerset Maugham	Perfect is determined in shortened measures of time, not over long periods of time or lifetimes. It would be unnatural.
Voltaire	Perfect is the enemy of good.
Antoine de Saint Exupery	Perfection is achieved, not when there is nothing more to add, but when there is nothing left to take away.
Edward Counsel	Perfection is an undiscovered jewel.
Thomas Leroy	Perfection is not just about control. It's also about letting go. Surprise yourself so you can surprise the audience.
Friedrich Nietzsche	Perhaps I know best why it is man alone who laughs; he alone suffers so deeply that he had to invent laughter.
Bertrand Russell	Philosophy, from the earliest times, has made greater claims, and achieved fewer results, than any other branch of learning.
Steve Maraboli	Plant seeds of happiness, hope, success, and love; it will all come back to you in abundance. This is the law of nature.
Unknown	Police have arrested the World tongue-twister Champion. I imagine he'll be given a tough sentence.
Rajesh Walecha	Possibility of life on any planet needs availability of air,water,sun-rays and vegetation not money and property.
Robert H. Schuller	Press on. Obstacles are seldom the same size tomorrow as they are today.
Tahir Shah	Previous journeys in search of treasure have taught me that a zigzag strategy is the best way to get ahead.
	Problems are the price of progress. Don't bring me anything but trouble. Good news weakens me.
Daniel C. Dennett	Problems in science are sometimes made easier by adding complications.
Paul Erdos	Problems worthy of attack prove their worth by fighting back.
Mary Lamia	Procrastination should not be linked with failure, just as early action should not be tied to success.
Marissa Mayer	Product management really is the fusion between technology, what engineers do - and the business side.
Amanda Cross	Professors of literature collect books the way a ship collects barnacles, without seeming effort.
Abhijit Naskar	Progress of the human society is predicated upon the proper functioning of a key element of the human mind, that is reasoning.
VAUVENARGUES	Prosperity makes some friends and many enemies.
Edward Thorndike	Psychology is the science of the intellects, characters and behavior of animals including man.
Isaac Asimov	Psychology marks the triumph of human evolution. How many other species would need a science of the mind?
QUARLES	Put off thy cares with thy clothes; so shall thy rest strengthen thy labor; and so shall thy labor sweeten thy rest.
Adam Silvera	Puzzles are sort of like life because you can mess up and rebuild later, and you're likely smarter the next time around.
Rajen Jani	Quality is all about taking care of the details.
Stephen Wright	Quantum Mechanics: The stuff dreams are made of.
Yuval Noah Harari	Questions you cannot answer are usually far better for you than answers you cannot question.
Stephen Hawking	Quiet people have the loudest minds.
	Radical historians now tell the story of Thanksgiving from the point of view of the turkey.
Patricia Cornwell	rain slowly slides down the glass as if the night is crying.
Abhilash 'Nox' Baruah	Rash decisions will more often than not, result in the demise of the chances you could have had with a situation; now foregone.
Christa McAuliffe	Reach for the stars.
Hank Green	Read books. Care about things. Get excited. Try not to be too down on yourself. Enjoy the ever present game of knowing.
Angela Carter	Reading a book is like re-writing it for yourself.
Nellotie Porter Chastain	Reading fills us with knowledge and exercises our emotions.
Tom Swyers	Real ballplayers pass the stuffing by rolling it up in a ball and batting it across the table with a turkey leg.
Ezra Pound	Real education must ultimately be limited to one who insists on knowing, the rest is mere sheep-herding.
Oscar Auliq-Ice	Real life can never have a written lie all over it.
Jules Verne	Reality provides us with facts so romantic that imagination itself could add nothing to them.
Farshad Asl	Regret is one the scariest words in any language and success is one of the most beautiful ones. What are you waiting for?
Bernard Branson	Rejection is an opportunity for your selection.
Vicki Corona	Remember that life is not measured by the number of breaths we take, but by the moments that take our breath away!
Roy T. Bennett	Remember that things are not always as they appear to be… Curiosity creates possibilities and opportunities.
Lois McMaster Bujold	Reputation is what other people know about you. Honor is what you know about yourself.
Steven Magee	Research is an endless loop of failures interspersed with occasional profound discoveries.
Marston Bates	Research is the process of going up alleys to see if they are blind.
Roy T. Bennett	Respect other people's feelings. It might mean nothing to you, but it could mean everything to them. 
	Results! Why, man, I have gotten a lot of results. I know several thousand things that won't work.
Werner Heisenberg	Revere those things beyond science which really matter and about which it is so difficult to speak.
	Reverie is when ideas float in our mind without reflection or regard of the understanding.
Elon Musk	Rockets are cool. There's no getting around that.
J.K. Rowling	said Sirius seriously
Jennifer Ritchie Payette	Save more than you spend, but do not hoard. Reinvest. Grow. Focus on replowing your fields so they bear fruit.
James Luceno	Science doesn't take sides, does it?
Marion Zimmer Bradley	Science fiction encourages us to explore... all the futures, good and bad, that the human mind can envision.
Brian Aldiss	Science fiction is no more written for scientists that ghost stories are written for ghosts.
Alex Hutchinson	Science has confirmed what athletes have always believed: that there's more in there—if you're willing to believe it.
Amit Kalantri	Science has given us the truth but taken away our tranquillity.
Anonymous	Science has now determined there is a direct relationship between the way the ball bounces and the cookie crumbles.
Oliver Wendell Holmes Sr.	Science is a first-rate piece of furniture for a man's upper chamber, if he has common sense on the ground floor.
Scott Adams	Science is a good thing. News reporters are good things too. But it's never a good idea to put them in the same room.
Tim Hunt	Science is about applying what we know and asking what we don't know.
Crane Brinton	Science is based not on faith but in skeptism
Kurt Vonnegut	Science is magic that works.
Bill Gaede	Science is not about making predictions or performing experiments. Science is about explaining.
Stephen Hawking	Science is not only a disciple of reason but, also, one of romance and passion.
Carl Sagan	Science is only a Latin word for knowledge
Herbert Spencer	Science is organized knowledge.
R. Buckminster Fuller	Science is the attempt to set in order the facts of experience.
Abhijit Naskar	Science is the human endeavor to elevate the self and the society from the darkness of ignorance into the light of wisdom.
Richard Dawkins	Science is the poetry of reality.
Brian Greene	Science is the process that takes us from confusion to understanding.
Donald Knuth	Science is what we understand well enough to explain to a computer. Art is everything else we do.
William Gurstelle	Science isn't just about blowing things up. Rather it's about blowing things up and knowing how you did it.
Richard Dawkins	Science replaces private prejudice with public, verifiable evidence.
Abraham Flexner	Science, in the very act of solving problems, creates more of them.
Michio Kaku	Scientific revolutions, almost by definition, defy common sense.
James A. Michener	Scientists dream about doing great things. Engineers do them.
Lailah Gifty Akita	Search for the good ways. And walk in right path.
Ray Bradbury	Self-consciousness is the enemy of all art, be it acting, writing, painting, or living itself, which is the greatest art of all.
Sunday Adelaja	Self-discovery is the key to knowing what to do with your life.
Dalai Lama XIV	Share your knowledge. It is a way to achieve immortality.
Cecelia Ahern	Shoot for the moon, even if you fail, you'll land among the stars
F. Scott Fitzgerald	Show me a hero and I will write you a tragedy.
James Joyce	Shut your eyes and see.
Sam Levenson	Siblings: children of the same parents, each of whom is perfectly normal until they get together.
	Sin lies only in hurting other people unnecessarily. All other "sins" are invented nonsense.
Steve Maraboli	Smile at strangers and you just might change a life.
Rajesh Walecha	Smile suppress worries as Rose suppress thorns.
Judy Blume	Snoring keeps the monsters away.
Malcolm X	So early in my life, I had learned that if you want something, you had better make some noise.
Stanley Victor Paskavich	So many wish for magic so many beg for fame, but if you could manifest anything you want life would be a boring game.
Will Durant	So the story of man runs in a dreary circle, because he is not yet master of the earth that holds him.
Jamie Zawinski	Software Engineering might be science; but that's not what I do. I'm a hacker, not an engineer.
Erol Ozan	Some beautiful paths can't be discovered without getting lost.
David Levithan	Some days are like this. And the only way to get through them is to remember that they are only one day, and that every day ends.
Michel de Montaigne	Some may feel a bittersweet pricking of malicious delight while contemplating misfortune by others.
Surgeo Bell	Some of the most beautiful things we have in life comes from our mistakes.
Jim Morrison	Some of the worst mistakes in my life were haircuts
Unknown	Some people feel the rain. Others just get wet.
Unknown	Some people only gets called by their nicknames. Usually it sounds weird to even say their real name.
Ruth Rendell	Some say life is the thing, but I prefer reading.
	Some scholars are like donkeys, they merely carry a lot of books.
Haruki Murakami	Some things in life are too complicated to explain in any language.
Tamora Pierce	Someday I must read this scholar Everyone. He seems to have written so much--all of it wrong.
Albert Einstein	Something deeply hidden had to be behind things.
Charles Schulz	Sometimes I lie awake at night and I ask, "Why me?", then a voice answers "Nothing personal, your name just happened to come up.
Arthur C. Clarke	Sometimes I think we're alone in the universe, and sometimes I think we're not. In either case the idea is quite staggering.
Ahmad Ardalan	Sometimes in life, a sudden situation, a moment in time, alters your whole life, forever changes the road ahead.
Alexandra Adornetto	Sometimes it's better to stop trying to make sense of things. Life isn't clear cut, there are always gray areas.
Anamika Mishra	Sometimes it's the complication, which just lies in our minds
Nicole Lyons	Sometimes love is nothing more than a sticky web; illusions spun from clever minds and bitter hearts.
	Sometimes people who live in glass houses throw stones because their windows are painted
Kellie Elmore	Sometimes the only way to ever find yourself is to get completely lost.
Mimi Novic	Sometimes the only way to find the answers, is not to travel far away, but to venture deeper within ourselves.
Dr. Seuss	Sometimes the questions are complicated and the answers are simple.
Abhijit Naskar	Sometimes to see the truth, you must turn blind to the obvious.
Suzy Kassem	Sometimes we have to soak ourselves in the tears and fears of the past to water our future gardens.
Jodi Picoult	Sometimes you can see things happen right in front of your eyes and still jump to the wrong conclusions.
Sophie Kinsella	sometimes you don't need a goal in life, you don't need to know the big picture. you just need to know what you're going to do next!
Jeannette Walls	Sometimes you need a little crisis to get your adrenaline flowing and help you realize your potential.
Jaree Francis	Sometimes you're not ready to give the world quite what it wants. And that's okay, because the Earth is generously patient.
Christopher Barzak	Sometimes you've got to be able to listen to yourself and be okay with no one else understanding.
Garth Stein	Somewhere, the zebra is dancing.
- Just Bill @WilliamAder	Sorry about last year, when I gave your Thanksgiving dinner a bad Yelp review, but those potatoes were "whipped," not "mashed.
Benjamin Franklin	Speak ill of no man, but speak all the good you know of everybody.
Cookie Monster	Speak softly and carry big cookie. Big enough to share with a good friend.
Lawrence Peter	Speak when you are angry, and you'll make the best speech you'll ever regret.
Sunday Adelaja	Specific knowledge is needed in every work, if we want to have success
Annie Dillard	Spend the afternoon, you can't take it with you.
Francis of Assisi	Start by doing what's necessary; then do what's possible; and suddenly you are doing the impossible.
Abhijit Naskar	Start small and keep going.
Debasish Mridha MD	Start your journey with purpose and vision, pursue it with great passion.
Amit Kalantri	State first, subject second, statesman last.
Henry Clay	Statistics are no substitute for judgment.
Evan Esar	Statistics: The only science that enables different experts using the same figures to draw different conclusions.
Steve Maraboli	Stay focused. Not every distraction is a worthy detour.
Lease L. Youmans	Stop sitting on the sidelines of everyone else's life and become and active participant in your own life.
Roshani Chokshi	Stories, knowledge...they set the mind alight.
Dolly Parton	Storms make trees take deeper roots.
Rod McKuen	Strangers are just friends waiting to happen.
Albert Einstein	Strive not to be a success, but rather to be of value.
COLTON	Strong as our passions are, they may be starved into submission, and conquered without being killed.
Kamal Ravikant	Success and failure come and go, but don't let them define you. It's who you are that matters.
Gerard de Marigny	Success can be defined in many ways but failure in only one ... quitting!
Chas. W. Wendte.	Success in life is a matter not so much of talent or opportunity as of concentration and perseverance.
Debasish Mridha	Success is a condition that gives us the ability to do what makes us happy.
Steve Backley	Success is a decision, not a gift.
Mapogo Chuene	Success is a game which we measure not by the intentions of our opponents, but by the effects of their play.
	Success is a tale of obstacles overcome, and for every obstacle overcome, an excuse not used.
Victor Bello Accioly	Success is complete only when it does not change who we are and neither pulls us away from our true friends.
Balroop Singh	Success is not just to be at peace with your achievements. It is also developing the ability to inspire people around you.
Muhammad Adb Al-Rahman Al-Arifi	Success is not to discover what others like, it is to acquire and practise the skills that help one gain their love.
Topsy Gift	Success is only possible to those whose hearts are willing and ready to embrace hard work
T. Jay Taylor	Success may require a lot of days. But progress only requires one.
Marianne Williamson	Success means we go to sleep at night knowing that our talents and ablities were used in a way that served others.
Debasish Mridha	Success without happiness is a mirage of life.
Ben Carson	Successful people don't have fewer problems. They have determined that nothing will stop them from going forward.
Jim Rohn	Successful people have libraries. The rest have big screen TVs
Isaac Asimov	Such is the respect for physicians that most people are astonished when one of them falls sick—and yet they do.
Bumper sticker.	Support bacteria, it's the only culture some people have.
Linda Shalaway	Take a deep breath, count to ten, and tackle each task one step at a time.
Goethe	Talents are best nurtured in solitude; character is best formed in the stormy billows of the world.
Bruce Dickinson	Teachers need to be more inspirational. But it's also up to engineering to make itself more interesting.
Hosea Ballou	Tears of joy are like the summer rain drops pierced by sunbeams.
Abhijit Naskar	Technology was supposed to be the help in life, instead it has become the major driving force behind life.
Thomas Babington Macaulay	Teh hgihest intallex, like teh tops of mountains, are the frist to ctach an two reflect teh dawn.
Jean Anthelme Brillat-Savarin	Tell me what you eat and I will tell you who you are.
Robert Beau	Thanksgiving would be better if the pilgrims had shot a lobster and the Indians brought French fries.
A. J. Cronin	That is life... to begin again when everything is lost!
John Bird	That was the week that was.
Calvin	That's the problem with nature. Something's always stinging you or oozing mucus on you. Let's go watch TV.
Jhumpa Lahiri	That's the thing about books. They let you travel without moving your feet.
Nicole Krauss	That's what I do. Watch movies and read. Sometimes I even pretend to write, but I'm not fooling anyone. Oh, and I go to the mailbox.
Tanya Masse	The ability to go from one failure to another without loss of enthusiasm is the ultimate foundation of success and strength.
George Lucas	The ability to speak does not make you intelligent.
Vince Lombardi	The achievemenst of an oragnizashun aer the rezults of teh combnied effrot of each indavidule.
Alexander Graham Bell	The achievement of one goal should be the starting point of another.
Brian Tracy	The act of taking the first step is what separates the winners from the losers.
Kelly Easton	The atoms of the earth are formed inside of stars. Nothing really dies, everything is transformed.
Anthony T.Hincks	The autonomy of life is known throughout the universe.
Von Clausewitz	The backbone of surprise is fusing speed with secrecy.
Steven Magee	The backbone of the electrical grid is largely massive numbers of steam driven engines that turn electrical generators.
Charles Baudelaire	The beautiful is always bizarre.
F.K. Preston	The belief in their actions can mend constellations. The ambition in their thirst for knowledge can both create and destroy.
Sukant Ratnakar, Quantraz	The best answers are hidden inside - explore within!
	The best argument against democracy is a five minute conversation with the average voter.
	The best substitute for brains is silence.
	The best things in life are never rationed. Friendship, loyalty, love do not require coupons.
Linus Pauling	The best way to have a good idea is to have a lot of ideas.
Criss Jami	The biggest challenge after success is shutting up about it.
Jim Rohn	The book you don't read won't help.
Isaac Asimov	The card-player begins by arranging his hand for maximum sense. Scientists do the same with the facts they gather.
Steve Pease	The challenge of life is to find a reason to be thankful in what seems on the surface to be a reason to complain.
Jim Fannin	The champion wins first, then walks into the arena. Everybody else walks into the arena and then tries to figure out what to do.
	The corruption in reporting starts very early. It's like the police reporting on the police.
Richard Feynman	The deeper a thing is, the more interesting it is
DeWayne Owens	The definition of comfort zone: Good is the enemy of your best.
	The Democrats are very bad at selling their own product. The Republicans are geniuses at it.
Sir William Osler	The desire to take medicine is perhaps the greatest feature which distinguishes man from animals.
Tom Clancy	The difference between fiction and reality? Fiction has to make sense.
Larry Niven	The dinosaurs became extinct because they didn't have a space program.
	The diseases which destroy a man are no less natural than the instincts which preserve him.
Anaïs Nin	The dream was always running ahead of me. To catch up, to live for a moment in unison, was the miracle.
Eraldo Banovac	The dynamic nature of knowledge is reflected in human progress and technological achievements.
Thabiso Monkoe	The earliest fisherman catches the fattest fish.
K. J. Parker	The easiest way to do anything is properly.
Deepak Chopra	The ego relies on the familiar. It is reluctant to experience the unknown, which is they very essence of life.
Carl Friedrich Gauss	The enchanting charms of this sublime science reveal only to those who have the courage to go deeply into it.
Aristotle	The energy of the mind is the essence of life.
Unknown	The engineer's first problem in any design situation is to discover what the problem really is.
Robertson Davies	The eye sees only what the mind is prepared to comprehend.
Abhijit Naskar	The first civilized being is not the one who wore a suit, but the one who stood up and said, I'll correct myself.
Toni Morrison	The function of freedom is to free someone else.
Frank Herbert	The function of science fiction is not always to predict the future but sometimes to prevent it.
John Sladek	The future, according to some scientists, will be exactly like the past, only more expensive.
Anonymous	The goal of science and engineering is to build better mousetraps. The goal of nature is to build better mice.
Aristotle	The gods too are fond of a joke.
Neil deGrasse Tyson	The good thing about the laws of physics is that they require no law enforcement agencies to maintain them
Helen Sharman	The government will see that human spaceflight is useful - for science and the economy - and inspirational.
Conan Doyle	The grand thing is to be able to reason backwards.
Michel de Montaigne	The greater part of the world's troubles are due to questions of grammar.
Michelangelo	The greatest danger for most of us is not that we aim too high and we miss it, but we aim too low and reach it.
Oprah Winfrey	The greatest discovery of all time is that a person can change his future by merely changing his attitude.
William Golding	The greatest ideas are the simplest.
Steve Maraboli	The greatest love stories are not those in which love is only spoken, but those in which it is acted upon.
Charles Lamb	The greatest pleasure I know, is to do a good action by stealth, and to have it found out by accident.
Walter Bagehot	The greatest pleasure in life is doing what people say you cannot do.
Albert A. Bartlett	The greatest shortcoming of the human race is our inability to understand the exponential function.
Robert Louis Stevenson	The habit of being happy enables one to be freed, or largely freed, from the domination of outward conditions.
Benjamin Franklin	The heart of a fool is in his mouth, but the mouth of a wise man is in his heart.
	The heart of a mother is a deep abyss at the bottom of which you will always find forgiveness.
	The height of cultivation runs to simplicity. Halfway cultivation runs to ornamentation.
Israelmore Ayivor	The height of your success will be measured with reference to the depth from which you started.
Vineet Raj Kapoor	The higher the obstacles, the higher we get to rise
Samuel Butler	The history of art is the history of revivals.
Neil Gaiman	The house smelled musty and damp, and a little sweet, as if it were haunted by the ghosts of long-dead cookies.
Jeff Bezos	The human brain is an incredible pattern-matching machine.
Unknown	The human brain is one of the most complex objects in the universe. Is it any wonder that so many people never learn to use it.
Leonardo da Vinci	The human foot is a masterpiece of engineering and a work of art.
Isaac Asimov	The human mechanism is marvelous. But why not—it is the result of three-and-a-half billion years of tinkering.
	The imaginary friends I had as a kid dropped me because their friends thought I didn't exist.
William Lawrence Bragg	The important thing in science is not so much to obtain new facts as to discover new ways of thinking about them.
	The important thing is not to stop questioning.
Stephen Hawking	The increase of disorder or entropy is what distinguishes the past from the future, giving a direction to time.
Ben Stein	The indispensable first step to getting the things you want out of life is this: decide what you want.
Lao Tzu	The journey of a thousand miles begins with a single step. Watch your step.
Beth Kempton	The journey of the Freedom Seeker isn't always easy. But it is essential, and it is urgent, for it is the path to coming alive again.
Ninon de Lenclos	The joy of a spirit is the measure of its power.
Sunday Adelaja	The leaders have the responsibility to protect and hold in high esteem the law and virtues of the land.
RSD	The Lesson is Life and Life is the Lesson, and the Lesson does not contain a single Atom.
Roy T. Bennett	The level of success you achieve will be in direct proportion to the depth of your commitment.
Chinese	The man of worth is really great without being proud; the mean man is proud without being really great.
Mark Twain	The man who does not read good books has no advantage over the man who cannot read them.
	The measure of a man's real character is what he would do if he knew he would never be found out.
Paul Dirac	The measure of greatness in a scientific idea is the extent to which it stimulates thought and opens up new lines of research.
Marshall McLuhan	The medium is the message.
Isaac Asimov	The mere existence of nuclear weapons by the thousands is an incontrovertible sign of human insanity.
Malebo Sephodi	The mirrors of capitalism will never reflect us as wealthy, successful or even worthy. - Change perception
G. Byrne.	The mole is a quantity of substance. The new prefix ' guaca ' is defined such that one guacamole equals Avocado's Number.
Shihab Kazi	The moment you need to get started is called "now".
Shannon L. Alder	The moon will guide you through the night with her brightness, but she will always dwell in the darkness, in order to be seen.
Michel Legrand	The more I live, the more I learn. The more I learn, the more I realize, the less I know.
Tarun Sharma	The more risk you can take upfront in life, the better off you will be later.
Compton Gage	The more thou search, the more thou shall marvel.
Elisabeth Foley	The most beautiful discovery true friends make is that they can grow separately without growing apart.
Albert Einstein	The most beautiful thing we can experience is the mysterious. It is the source of all true art and science.
William Lloyd George	The most dangerous thing in the world is to try to leap a chasm in two jumps.
Isaac Asimov	The most exciting phrase to hear in science, the one that heralds new discoveries, is not 'Eureka!' but 'That's funny...'
Isaac Asimov	The most exciting phrase to hear in science, the one that heralds the most discoveries, is not 'Eureka!' but 'That's funny…'
Debasish Mridha MD	The most important goal of education is to pursue the ultimate purpose of life, to achieve success with happiness.
John Wooden	The most important key to achieving great success is to decide upon your goal and launch, get started, take action, move.
Stephen Hawking	The most important point: that the universe is governed by a set of rational laws that we can discover and understand.
Nicolas Chamfort	The most wasted of all days is one without laughter.
Roshan Sharma	The natural order of life is not the thinking and imagination, but living in the moment, with absolute trust.
George F. Will	The nice part about being a pessimist is that you are constantly being either proven right or pleasantly surprised.
	The nice thing about being a celebrity is that, if you bore people, they think it's their fault.
Marcus Aurelius	The object of life is not to be on the side of the majority, but to escape finding oneself in the ranks of the insane.
Roy T. Bennett	The one who falls and gets up is stronger than the one who never tried. Do not fear failure but rather fear not trying.
Cesare Pavese	The only joy in the world is to begin.
Franklin Delano Roosevelt	The only limit to our realization of tomorrow will be our doubts of today.
Vince Lombardi	The only place success comes before work is in the dictionary.
Albert Einstein	The only real valuable thing is intuition.
Albert Einstein	The only reason for time is so that everything doesn't happen at once.
Henry Ford	The only true test of values, either of men or of things, is that of their ability to make the world a better place in which to live.
Arthur C. Clarke	The only way of discovering the limits of the possible is to venture a little way past them into the impossible.
Maged Gamani	The only way to fail, is when you allow it to happen.
	The optimist says the glass is half full, the pessimist say the glass is half empty, the engineer says the glass is too large.
Sarah Gerdes	The Overlooked Expert is the person who's fully capable of starting and running a profitable business.
Queen Elizabeth I	The past can not be cured.
Shaun S. Lott	The pendulum of life swings equally to both sides until friction is applied
Voltaire	The perfect is the enemy of the good.
Johann Wolfgang von Goethe	The person born with a talent they are meant to use will find their greatest happiness in using it.
Cecil B. DeMille	The person who makes a success of living is the one who sees his goal steadily and aims for it unswervingly. That is dedication.
Albert Einstein	The physicist's greatest tool is his wastebasket.
Robert M. Pirsig	The place to improve the world is first in one's own heart and head and hands, and then work outward from there.
Lailah Gifty Akita	The possibility of the dream gives strength.
George Bernard Shaw	The power of accurate observation is frequently called cynicism by those who don't have it.
Norhafsah Hamid	The power of knowledge is so great and forceful, if only we knew.
Henri Bergson	The present contains nothing more than the past, and what is found in the effect was already in the cause.
David Russell	The present is a point just passed.
	The present is a rope stretched over the past. The secret to walking it is, you never look down.
Ralph Waldo Emerson	The prize will not be sent to you. You have to win it.
Jennifer Niven	The problem with people is they forget that most of the time it's the small things that count.
Bernie DeKoven	The purpose of fun is to live it.
Albert Einstein	The pursuit of truth and beauty is a sphere of activity in which we are permitted to remain children all our lives.
Francis Bacon	The real and legitimate goal of the sciences is the endowment of human life with new commodities.
Marty Rubin	The real mystery is the known, not the unknown.
	The real trouble with war (modern war) is that it gives no one a chance to kill the right people.
Rajesh Walecha	The reality exists within and we are searching it in gamut of illusion.
W. Clement Stone	The reason so few people are successful is no one has yet found a way for someone to sit down and slide uphill.
Ralph Waldo Emerson	The reward of a thing well done is having done it.
Mike Carey	The right idea at the right time is like a dandelion...You may hack it down, but you only spread the seeds abroad.
Herman Hesse	The river is everywhere.
Wasif Minhas	The river of emotions will almost always over-run the barrage of logic.
Ken Norris	The scientific method is nothing more than a system of rules to keep us from lying to each other.
Mark Russell.	The scientific theory I like best is that the rings of Saturn are composed entirely of lost airline luggage.
Jason Silva	The scientist and engineers who are building the future need the poets to make sense of it.
Erwin Schrödinger	The scientist only imposes two things, namely truth and sincerity, imposes them upon himself and upon other scientists.
Sunday Adelaja	The secret of all greatness is knowing what to do with time.
Marcus Aurelius	The secret of all victory lies in the organization of the non-obvious.
Aristotle Onassis	The secret of success is to know something nobody else knows.
Benjamin Disraeli	The secret to success is constancy of purpose.
Victor Borge	The shortest distance between two people is a smile.
Albert Einstein	The significant problems of our time cannot be solved by the same level of thinking that created them.
Albert Einstein	The significant problems we have cannot be solved at the same level of thinking with which we created them.
	The signs of the zodiac are karmic patterns; the planets are the looms; the will is the weaver.
Adam Braun	The single most powerful element of youth is that you don't have the life experiences to know what can't be done.
Suzy Kassem	The smaller the creature, the bolder its spirit.
Isaac Asimov	The solar system consists of Jupiter plus debris.
Daniel Defoe	The soul is placed in the body like a rough diamond, and must be polished, or the lustre of it will never appear.
Irvin D. Yalom	The spirit of a man is constructed out of his choices.
Steve Backley	The sprint is like life ... blink and you miss it.
SENECA	The state of that man's mind who feels too intense an interest as to future events, must be most deplorable.
Lailah Gifty Akita	The strength of every individual is the grace for great work.
CONFUCIUS	The superior man wishes to be slow in his words and earnest in his conduct.
Giacomo Leopardi	The surest way of concealing from others the boundaries of one's own knowledge is not to overstep them.
Richard Feynman	The thing that doesn't fit is the thing that's the most interesting: the part that doesn't go according to what you expected.
JOHN TASKINSOY	The three great essentials of success are, first, try; second, try again; and third, keep trying.
Steve Backley	The thrust of continuous action is the firewood which fuels motivation.
	The time is near at hand which must determine whether Americans are to be free men or slaves.
	The time to be happy is now. The place to be happy is here. The way to be happy is to make others so.
Jim Rohn	The ultimate reason for setting goals is to entice you to become the person it takes to achieve them.
Steve Maraboli	The universe doesn't give you what you ask for with your thoughts - it gives you what you demand with your actions.
Stephen Hawking	The Universe in a Nutshell
Peter DeVries	The universe is like a safe to which there is a combination - but the combination is locked up in the safe.
Muriel Rukeyser	The universe is made of stories, not of atoms.
Barbara Tuchman	The unrecorded past is none other than our old friend, the tree in the primeval forest which fell without being heard.
Brian O'Driscoll	The victory is always sweeter... winning things with friends.
Carl Sagan	The visions we offer our children shape the future.
Sherlock	The way a person stands may disguise who they are.
FRANKLIN	The way to wealth is as plain as the road to market. It depends chiefly on two words, industry and frugality.
Isaac Asimov	The wish to believe, even against evidence, fuels all the pseudosciences from astrology to creationism.
Will Henry	The wishbone will never replace the backbone
Jacob Bronowski	The world can only be grasped by action, not by contemplation...The hand is the cutting edge of the mind.
Sherman Alexie	The world even the smallest parts of it, is filled with things you don't know.
Oscar Wilde	The world is a stage and the play is badly cast.
Elbert Hubbard	The world is moving so fast these days that the man who says it can't be done is generally interrupted by someone doing it.
Sean Carroll	The world keeps happening, in accordance with its rules; it's up to us to make sense of it and give it value.
Alice Feeney	The world keeps on spinning, repeating itself over and over until something changes, which it doesn't because we can't.
Woodrow Wilson	The world must be made safe for democracy. Its peace must be planted upon the tested foundations of political liberty.
Socrates	The world's a puzzle; no need to make sense out of it.
Isaac Asimov	The worlds of our solar system are widely different, but all share a common gravitational tie to the sun.
Charles Kettering	The Wright brothers flew right through the smoke screen of impossibility.
Ralph Waldo Emerson	The years teach much which the days never know.
Oscar Wilde	The youth of America is their oldest tradition. It has been going on now for three hundred years.
	Their are to weighs two pass a hurdle: leaping over oar plow wing threw... Their need stew bee a monster truck option.
Belsebuub	Theirs a nowledge tath is beynod teh mnid adn the intellect, it is the wisdum of consciousness.
Jodi Picoult	There are always sides. There is always a winner, and a loser. For every person who gets, there's someone who must give.
Charles Dickens	There are books of which the backs and covers are by far the best parts.
	There are eight planets, unless of course you still count Pluto in which case there are nine million planets.
Hippocrates	There are in fact two things, science and opinion; the former begets knowledge, the later ignorance.
Hippocrates	There are in fact two things, science and opinion; the former begets knowledge, the latter ignorance.
George Polyá	There are many questions which fools can ask that wise men cannot answer.
Rainer Maria Rilke	There are no classes in life for beginners: right away you are always asked to deal with what is most difficult.
Napoleon Hill	There are no limitations to the mind except those that we acknowledge.
Colin L. Powell	There are no secrets to success. It is the result of preparation, hard work and learning from failure.
Zig Ziglar	There are no traffic jams on the extra mile.
	There are people whose watch stops at a certain hour and who remain permanently at that age.
Mary Hoffman	There are some choices you can only make once. You can't go back to where you made a choice and then take the other one.
Frederick William Faber	There are souls in this world who have the gift of finding joy everywhere, and leaving it behind them when they go.
Galileo Galilei	There are those who reason well, but they are greatly outnumbered by those who reason badly.
Rex Todhunter Stout	There are two kinds of statistics, the kind you look up and the kind you make up.
Einstein	There are two ways to live your life. One is as though nothing is a miracle. The other is as though everything is a miracle.
Stephen King	There came a time when you realized that moving on was pointless. That you took yourself with you wherever you went.
Shannon L. Alder	There comes a time in your life when you have to choose to turn the page, write another book or simply close it.
Stephen Hawking	There could be whole antiworlds and antipeople made out of antiparticles. However, if you meet your antiself, don't shake hands!
Jeanette Winterson	There is a certain seductiveness about dead things. You can ill treat, alter and recolour what's dead. It won't complain.
Debasish Mridha MD	There is a gap between dreams and reality. Don't fear this gap, but zap it with action, persistence and perseverance.
Henry Van Dyke	There is a loftier ambition than merely to stand high in the world. It is to stoop down and lift mankind a little higher.
David Eagleman	There is a looming chasm between what your brain knows and what your mind is capable of accessing.
	There is a very easy way to return from a casino with a small fortune: go there with a large one.
Isaac Asimov	There is an art to science, and science in art; the two are not enemies, but different aspects of the whole.
Mahatma Gandhi	There is more to life than simply increasing its speed.
James Russell Lowell	There is no good in arguing with the inevitable. The only argument available with an east wind is to put on your overcoat.
J. B. S. Haldane	There is no great invention, from fire to flying, which has not been hailed as an insult to some god.
John Millington Synge	There is no language like the Irish for soothing and quieting.
	There is no meaning to life except the meaning man gives his life by unfolding of his powers.
Nelson Mandela	There is no passion to be found playing small - in settling for a life that is less than the one you are capable of living.
Bob Iger	There is no science in creativity. If you don't give yourself room to fail, you won't innovate.
John Kramer	There is no success where there are no secrets.
Frank Serafini	There is no such thing as a child who hates to read; there are only children who have not found the right book.
Gayatri Gadre	There is no U-turn in life, what is done, is done, what you have missed, you missed. You can't go back and revisit it
Stephen Hawking	There is no way that we can predict the weather six months ahead beyond giving the seasonal average
Carlos Ruiz Zafón	There is nothing in the path of life that we don't already know before we start. Nothing is learned; it is simply remembered.
Marcel Proust	There is nothing like desire for preventing the thing one says from bearing any resemblance to what one has in mind.
Sir J. Lubbock.	There is nothing ridiculous in seeming to be what you really are, but a good deal in affecting to be what you are not.
	There is nothing that will kill a man so soon as having nobody to find fault with but himself.
Ralph Waldo Emerson	There is one other reason for dressing well, namely that dogs respect it, and will not attack you in good clothes.
Norman Vincent Peale	There is real magic in enthusiasm. It spells the difference between mediocrity and accomplishment.
Joe L. Wheeler	There is something incredibly nostalgic and significant about the annual cascade of autumn leaves.
Isaac Asimov	There is something particularly human about using tools; the first and most important tool being language.
Aaron Lauritsen	There is strange comfort in knowing that no matter what happens today, the Sun will rise again tomorrow.
Unknown	There may be no excuse for laziness, but I'm still looking.
Cassandra Clare	There was beauty in the idea of freedom, but it was an illusion. Every human heart was chained by love.
Alec Baldwin	there was nothing to be ashamed of in doing jobs simply to make a living, so long as those jobs fueled other creative efforts
David Halberstam	There was, I found, always more to learn.
	There's a common myth that evidence speaks for itself. It doesn't. It just sits there on the lab table, incapable of speaking.
Randy Pausch	There's a limit to how many times you can read how great you are and what an inspiration you are, but I'm not there yet.
WISDOM KWASHIE MENSAH	There's joy in every circumstance. The beginning is bitter, but in between, there are valuable lessons that bring joy.
	There's no tragedy in life like the death of a child. Things never get back to the way they were.
Najwa Zebian	These mountains that you are carrying, you were only supposed to climb.
Dr. Seuss	They say I'm old-fashioned, and live in the past, but sometimes I think progress progresses too fast!
Karen White	They say that not matter how old you become, when you are with your siblings, you revert back to childhood.
Mike Schmoker	Things get done only if the data we gather can inform and inspire those in a position to make difference.
Langston Hughes	Think before you speak. Read before you think.
Tim Ferriss	Think BIG and don't listen to people who tell you it can't be done. Life's too short to think small.
Taisen Deshimaru	Think with your whole body.
Moses Hadas	This book fills a much-needed gap.
William Arthur Ward	This bright new year is given me to live each day with zest, to daily grow and try to be my highest and my best!
Richelle Mead	This college would probably have the same problem as the last one did."I frowned, "What's that?""Homework.
	This I conceive to be the chemical function of humor - to change the character of our thought.
Sunday Adelaja	Those irritations and uneasiness you are faced with are evidence that you have an assignment to fulfill.
Nicolaus Copernicus	Those things which I am saying now may be obscure, yet they will be made clearer in their proper place.
Leena Ahmad Almashat	Those who don't jump will never fly.
Sunday Adelaja	Those who fight for social justice and the rights of people will count any other thing as unimportant.
Natsuki Takaya	Those who hurt others will also hurt themselves.
Mokokoma Mokhonoana	Those who know the least want to be heard the most.
	Those who occupy their minds with small matters, generally become incapable of greatness.
Abraham Lincoln	Thoughtful men must feel that the fate of civilization upon this continent is involved in the issue of our contest. 
Suzy Kassem	Three things have a limited threshold:Time, pain, and death.While truth, love, and knowledge 'Are boundless.
JOHN TASKINSOY	Throughout my life, I have not done things just because somebody deemed important; this why I am successful today.
Edwin Way Teale	Thyme and space - thyme two bee alone, space two move about - these may well bee the grate scarcities of tomorrow
HAWTHORNE	Time flies over us, but leaves its shadow behind.
Rodel Dosado	Time is not made of atoms to manipulate it back.
Neel Preet	Time is the real emperor and there is no space for any pride since time flies and blows away anything.
Tarun Sharma	Time is the single most important resource that we have. Every single minute we lose is never coming back.
Ann Brashares	Time is what keeps things from happening all at once.
Sunday Adelaja	Time plays a major role in achieving success
William Shakespeare	Tis an ill cook that cannot lick his own fingers.
Abhishek Aditeya	To achieve great success, you first have to learn to admire great failure.
Debasish Mridha MD	To be a success, think of happiness.
Debasish Debha, M.D.	To be a tremendous success, look for opportunity rather than security.
Confucius	To be fond of learning is near to wisdom.
Galileo Galilei	To be humane, we must ever be ready to pronounce that wise, ingenious and modest statement 'I do not know'.
Debasish Mridha MD	To be noble, help others to succeed
Wilson Kanadi	To be the best, you must be able to handle the worst.
Laura Linney	To be too knowing is a downfall.
Georges Canguilhem	To err is human, to persist in error is diabolical.
Karen Horney	To find a mountain path all by oneself gives a greater feeling of strength than to take a path that is shown.
Lailah Gifty Akita	To have hope is to be happy.
Debasish Mridha MD	To listen be silent, to succeed be persistent
Philip K. Dick	To live is to be haunted.
	To love someone deeply gives you strength. Being loved by someone deeply gives you courage.
Isaac Newton	To me there has never been a higher source of earthly honor or distinction than that connected with advances in science.
Sebastian Thrun	To me, mathematics, computer science, and the arts are insanely related. They're all creative expressions.
	To myself, personally, it brings nothing but increasing drudgery and daily loss of friends.
Iimani David	To protect themselves, the weak focus on the "bad" in people. Conversely, the strong, who fear little, focus on the "good".
Sunday Adelaja	To some extent, it is almost blasphemous to think that insult, anger and irritation could be a positive force.
Douglas Adams	To summarize the summary of the summary: people are a problem.
Isaac Asimov	To test a perfect theory with imperfect instruments did not impress the Greek philosophers as a valid way to gain knowledge.
Libba Bray	To those who will see, the world waits.
Charlie Chaplin	To truly laugh, you must be able to take your pain, and play with it.
Aristotle	To write well, express yourself like the common people, but think like a wise man.
Eleanor Roosevelt	Today is the oldest you've ever been, and the youngest you'll ever be again.
Dr. Seuss	Today was good. Today was fun. Tomorrow is another one.
Edward Young	Too low they build, who build beneath the stars.
Sarah Dessen	Too many locks, not enough keys.
Nicholas Sparks	Too many people seem to believe that silence was a void that needed to be filled, even if nothing important was said.
Steve Backley	Too often, people get stuck in a state of over-thinking, the result is that they never reach a decision.
Greg Easterbrook	Torture numbers, and they'll confess to anything.
David Mitchell	Travel far enough, you meet yourself.
Debasish Mridha, M.D.	Treat everyone in every situation with kindness; it is the ultimate purpose and wisdom of life.
Ahmed Omaar	Trees make me beleve taht wee can also renew and reshape hour lives, know madder wat wee face inn lyfe
Ahmed Omaar	Trees make me believe that we can also renew and reshape our lives, no matter what we face in life.
Benjamin Franklin	Trouble knocked at the door, but, hearing laughter, hurried away
Henry David Thoreau	True friendship can afford true knowledge. It does not depend on darkness and ignorance.
Hazel Butterworth	Trust your inner guidance and follow your heart, for your soul has your blueprint and the universe has your back.
Toba Beta	Truth ain't be in secret site to be found.It lies within certain levels of understanding and knowledge.
Toba Beta	Truth ain't bee inn secret site two bee found. It lies within certain levels of under standign and now ledge.
Andy Weir	Turns out even NASA can't improve on duct tape.
Unknown	Two snowmen in a field, one turned to the other and said "I don't know about you but I can smell carrots!"
Debasish Mridha	Two things prevent you from becoming a success: dwelling in the past with regret, and following others blindly.
Weike Wang	Uh hall mark of siecnce is seting out two discoevr won thing and then discovering somthin else.
Unknown	Uh strate face and a sincere sounding "Huh?" have gotten meow of more trouble than eye can remember.
E. E. Cummings	Unbeing dead isn't being alive.
David Bohm	Universe consists of frozen light.
Nikola Tesla	Unlocking some secrets of the universe needs thinking in terms of energy, frequency and vibration.
Jessa Stephens	Until you deal with the core of the problem—nothing changes. Life is about choices; choices make a change.
Lorii Myers	Upon achieving a lifelong dream, I thought, this is the way to live your life -- in the moment, and to the fullest.
Henry Ward Beecher	Victories that are easy are cheap. Those only are worth having which come as the result of hard fighting.
Chessmaster Savielly Grigorievitch Tartakower	Victory goes to the player who makes the next-to-last mistake.
Mike Marshall	Victory is in the quality of the competition, not just the final score.
E.A. Bucchianeri	Victory only comes through wear and tear.
Tobi Delly	Vision is your first creation of the future.
Ian Desabrais	Waiting around to be perfect never amounts to anything. Don't be a waiter or you'll be serving other people.
Unknown	Waiting to develop courage is just another form of procrastination. The most successful people take action while they're afraid!
Ally Carter	Waiting. Like it or not, it's a skill all spies have to master eventually.
A.P.J. Abdul Kalam	War is never a lasting solution for any problem.
	War is the statesman's game, the priest's delight, The lawyer's jest, the hired assassin's trade.
Stephen Covey	Watt ever is at teh centa of hour life will bee teh source of hour securaty, guidance, wiz dumb, and power
Niels Bohr	We all agree that your theory is crazy, but is it crazy enough?
N. R. Narayana Murthy	We all, as engineers, doctors, have a big responsibility to bring smiles on the faces of suffering humanity.
John W. Gardner	We are continually faced with a series of great opportunities brilliantly disguised as insoluble problems.
Kavita Bhupta Ghosh	We are so busy teaching small things about life to children that we forget to learn big things from them.
Douglas Adams	We are stuck with technology when what we really want is just stuff that works.
Dirk Wittenborn	We are the sum of all people we have ever met; you change the tribe and the tribe changes you.
Veronica Roth	We believe in ordinary acts of bravery, in the courage that drives one person to stand up for another. 
Werner von Braun	We can lick gravity, but the paperwork's a bit tougher.
CHATEAUBRIAND	We can prostrate ourselves in the dust when we have committed a fault, but it is not best to remain there.
Randy Pausch	We cannot change the cards we are dealt, just how we play the hand.
Lailah Gifty Akita	We cannot just live any how.
Ronald Reagan	We can't help everyone, but everyone can help someone.
Walt Whitman	We convince by our presence.
Maya Angelou	We delight in the beauty of the butterfly, but rarely admit the changes it has gone through to achieve that beauty.
Patricia King	We don't have to be thankful for an adverse situation, but we can be thankful for all the good things that sustain us.
Stephen Hawking	We each exist for but a short time, and in that time explore but a small part of the whole universe
Maria Mitchell	We especially need imagination in science. It is not all mathematics, nor all logic, but it is somewhat beauty and poetry.
Ludwig Wittgenstein	We feel that even if all possible scientific questions be answered, the problems of life have still not been touched at all.
E. B. Browning.	We get no good by being ungenerous, even to a book.
	We hate to have some people give us advice because we know how badly they need it themselves.
Jane Austen	We have all a better guide in ourselves, if we would attend to it, than any other person can be.
Winston Churchill	We have always found the Irish a bit odd. They refuse to be English.
Friedrich Nietzsche	We have art to save ourselves from the truth.
Douglas Adams	We have normality. I repeat, we have normality. Anything you still can't cope with is therefore your own problem.
Richard L. Ratliff	We learn and grow Always building on what we know
Sharon Salzberg	We long for permanence but everything in the known universe is transient. That's a fact but one we fight.
Yogi Berra	We made too many wrong mistakes.
Steve Maraboli	We may place blame, give reasons, and even have excuses; but in the end, it is an act of cowardice to not follow your dreams.
Mahatma Gandhi	We must be the change we wish to see in the world.
David Mamet	We must have a pie. Stress cannot exist in the presence of a pie.
Carl Sagan	We must understand the Cosmos as it is and not confuse how it is with how we wish it to be.
Lailah Gifty Akita	We must work while we have strength.
Janaki Sooriyarachchi	We need no language to laugh
George Eliot.	We prepare ourselves for sudden deeds by the reiterated choice of good or evil, that gradually determines character.
Benjamin Franklin	Well done is better than well said.
E.A. Bucchianeri	Well, if it can be thought, it can be done, a problem can be overcome,
Rajen Jani	Well-intentioned but ill-informed actions usually compromise quality.
Martin Fraquhar Tupper	Well-timed silence hath more eloquence than speech.
J.K. Rowling	We're all human, aren't we? Every human life is worth the same, and worth saving.
Jason Kidd	We're going to turn this team around 360 degrees.
David Hanson	We're seeing the arrival of conversational robots that can walk in our world. It's a golden age of invention.
Bill Watterson	We're so busy watching out for what's just ahead of us that we don't take time to enjoy where we are.
Isaac Asimov	We've lost all geographical frontiers on Earth, but new and far larger ones exist at Earth's doorstep.
Anonymous.	We've made great medical progress in the last generation. What used to be merely an itch is now an allergy.
Alice Bag	What a waste my life would be without all the beautiful mistakes I've made.
Scott Adams.	What are the odds that you are the first generation of humans who will understand reality ?
Isaac Asimov	What can be more important than the science of life to any intelligent being who has the good fortune to be alive?
Unknown	What did the light bulb say to the switch? "You turn me on."
Unknown	What did the pirate say when he found someone? I sea you!
Unknown	What did the stamp say to the envelope on Valentine's Day? "I'm stuck on you!"
Unknown	What did the vegan say? I made a big missed steak.
Unknown	What do you have to do to have a party in space? You have to Planet.
Douglas Adams	What does it matter? Science has achieved some wonderful things, of course, but I'd far rather be happy than right any day.
Unknown	What dog can't bark? A hot dog.
	What I call a good patient is one who, having found a good physician, sticks to him till he dies.
John Green	What I love about science is that as you learn, you don't really get answers. You just get better questions.
Albert Camus	What is a rebel? A man who says no.
Unknown	What is an alien's favorite candy? A Mars bar!
Johann Wolfgang von Goethe	What is not started today is never finished tomorrow.
Unknown	What is the most important thing to learn in chemistry? Never lick the spoon.
Ralph Waldo Emerson	What lies behind us and what lies before us are tiny matters compared to what lies within us.
Richard Dawkins	What matters is not the facts but how you discover and think about them.
Antoine de Saint-Exupéry	What saves a man is to take a step. Then another step.
De philosopher DJ Kyoss	What should scare you is not knowing what you don't know. Always be eager to learn for knowledge is power.
Plutarch	What we achieve inwardly will change outer reality.
Theodore Roethke	What we need is more people who specialize in the impossible.
Sir John Lubbock	What we see depends mainly on what we look for.
Buddha	What we think, we become.
Unknown	What will fall on the lawn first? An autumn leaf or a Christmas catalog?
Unknown	What would you get if you crossed a athlete and the Invisible Man?… Sports like no one has ever seen.
Jane Goodall	What you do makes a difference, and you have to decide what kind of difference you want to make.
Stephen Hawking	What you have told us is rubbish. The world is really a flat plate supported on the back of a giant tortoise.
Sujit Lalwani	What You were Once, Was Also Because You Were Someone Else Before that
Isaac Asimov	Whatever else astronomy may or may not be who can doubt it to be the most beautiful of the sciences?
Lolly Daskal	Whatever you will accomplish is restricted by your ability to lead others.
Unknown	What's a horse's favorite sport? Stable Tennis.
Trisha Yearwood	What's meant to be will always find a way
Brian Cox	Whee our the cosmos made conchus and lief is teh measn by witch the uinverse undertsands istelf.
Arthur C. Clarke	When a distinguished but elderly scientist states that something is possible, he is almost certainly right.
Arthur Golden	When a stone is dropped into a pond, the water continues quivering even after the stone has sunk to the bottom.
George Bernard Shaw	When a thing is funny, search it carefully for a hidden truth.
Jonathan Swift	When a true genius appears in the world, you may know him by this sign, that the dunces are all in confederacy against him.
	When an idea reaches critical mass there is no stopping the shift its presence will induce.
HENRY DAVID THOREAU	When I hear music, I fear no danger. I am invulnerable. I see no foe. I am related to the earliest times, and to the latest.
Prashant Yadav	When in a frying pan, thank your stars. You will reminisce about it moments later, when you fall in the fire.
Joan Marques	When it rains it pours. Maybe the art of life is to convert tough times to great experiences: we can choose to hate the rain or dance in it.
Samuel Lover	When once the itch of literature comes over a man, nothing can cure it but the scratching of a pen.
Marissa Mayer	When people think about computer science, they imagine people with pocket protectors and thick glasses who code all night.
Bernard Bailey	When science finally locates the center of the universe, some people will be surprised to learn they're not it.
Valeria Teles	When seeing life for what it is becomes more important than seeing it your way, you'll finally understand what courage means.
Bangambiki Habyarimana	When something looks impossible, don't give up without testing its impossibility
Roy T. Bennett	When the going gets tough, put one foot in front of the other and just keep going. Don't give up.
Cecil Selig	When the grass looks greener on the other side of the fence, it may be that they take better care of it there.
Lailah Gifty Akita	When the spirit is happy, the soul is full of smiles.
Arthur Francis Gabriel	When the World does not make sense to you, is the day you become sensible!
Robert Asprin	When things are at their blackest, I say to myself, 'Cheer up, things could be worse.' And sure enough, they get worse.
Marianne Williamson	When we are centered in joy, we attain our wisdom.
Carl Sagan	When we look up at night and view the stars, everything we see is shinning because of distant nuclear fusion.
Sunday Adelaja	When we neglect knowledge, we have indirectly rejected light.
William Arthur Ward	When we seek to discover the best in others, we somehow bring out the best in ourselves.
Sunday Adelaja	When what you are insulted by meets what you have a strong desire to do, then that would bring you significance.
RuPaul	When you become the image of your own imagination, it's the most powerful thing you could ever do.
Seema Brain Openers	When you develop yourself, you grow humanity.
Friedrich Nietzsche	When you gaze long into the abyss, the abyss also gazes into you.
Joseph Joubert	When you go in search of honey, you must expect to be stung by bees.
Chad Hurley	When you have a group of engineers and designers, they are not exactly the best to deal with copyright law.
	When you look up at the sky, you have a feeling of unity, which delights you and makes you giddy.
Roy T. Bennett	When you open your mind, you open new doors to new possibilities for yourself and new opportunities to help others.
Nora Ephron	When your children are teenagers, it's important to have a dog so that someone in the house is happy to see you.
Benjamin Franklin	When you're testing to see how deep water is, never use two feet.
Unknown	Where does the Easter Bunny go when he needs a new tail? To a re-tail store!
Henry Ward Beecherr	Where is human nature so weak as in the bookstore?
Robert Evans Snodgrass	Where the facts themselves are highly interesting, the explanation of them must be still more so.
Publilius Syrus	Where there is unity there is always victory.
Lolly Daskal	Where we fall are the stepping-stones for our journey.
Werner Heisenberg	Whether we like it or not, modern ways are going to alter and in part destroy traditional customs and values.
Euclid fl. c.300 B.C.	Which was to be proved.
Lailah Gifty Akita	Who can count the sand by the sea?
T.F. Hodge	Who dare tries is a success, and shall master the art of conquering dreams.
William Goldman	Who says life is fair, where is that written?
Lailah Gifty Akita	Whoever holds the keys to house of knowledge, must open the door, for those who search for light of knowledge to enter.
Albert Einstein	Whoever is careless with the truth in small matters cannot be trusted with important matters
Benjamin Franklin	Whoever would overthrow the liberty of a nation must begin by subduing the freeness of speech.
Brian Clark	Whose life is it anyway?
Unknown	Why didn't the dog want to play football? It was a boxer!
Unknown	Why do shepherds never learn to count? Because if they did they would always be falling asleep.
Unknown	Why does someone who runs marathons make a good student? Because education pays off in the long run!
Alan Shepard	Why don't you light that candle ?
Nora Joyce to her husband James	Why don't you write books people can read?
CK	Why? Learn, and Innovate!
Avina Celeste	Win or lose, you are trying, that's what matters.
Bum Phillips	Winning is only half of it. Having fun is the other half.
Albert Einstein	Wisdom is not a product of schooling but of the lifelong attempt to acquire it.
Edward Hersey Richards	Wisdom is the daughter of experience.
Mark Van Doren	Wit is the only wall between us and the dark.
David Benedict Zumbo	With time involved, everything is temporary.
Andrew Kendall	With time we learn that the things we're better off without have the ability to lead us somewhere better than we were before.
Robin Kimmerer	With words at your disposal, you can see more clearly. Finding the words is another step in learning to see.
Ralph Waldo Emerson	Without ambition one starts nothing. Without work one finishes nothing. The prize will not be sent to you. You have to win it.
Lailah Gifty Akita	Without knowledge, we are weak.
Jane Austen	Without music, life would be a blank to me.
Francis Bacon	Wonder is the seed of knowledge
Gift Gugu Mona	Words have an immeasurable impact, they can either build or destroy so be careful of your words.
Benjamin Franklin	Words may show a man's wit, actions his meaning.
Ngũgĩ wa Thiong'o	Written words can also sing.
	Yell codebusters rule for a hundred extra points
Patrick Ness	Yesterday I was clever, so I wanted to change the world. Today I am wise, so I am changing myself.
Amit Ray	Yoga is an exact science in the form of poetry when we measure the flow of neurotransmitters in the brain.
Amit Ray	You are never alone. You are eternally connected with everyone.
Ogden Nash	You are only young once, but you can stay immature indefinitely.
James Allen	You are today where your thoughts have brought you; you will be tomorrow where your thoughts take you.
Janis Joplin	You are what you settle for. You are only as much as you settle for
Carl Sagan	You are worth about 3 dollars worth in chemicals.
Brittany Burgunder	You aren't doing "nothing" when you choose to put your wellbeing first. In fact, this is the key to having everything.
Benjamin Franklin	You can do anything you set your mind to
Maxwell Maltz	You can do only one thing at a time. I simply tackle one problem and concentrate all efforts on what I am doing at the moment.
Mokokoma Mokhonoana	You can know a lot and still be stupid.
Richmond Akhigbe	You can start from the ordinary bizzare to the extraordinary incredible
Orrin Woodward	You cannot be upset about results you don't have from work you didn't do.
Joshua Suya Pelicano	You cannot explore the universe if you think that you are the center of it.
Stephen Hawking	You cannot predict the future.
Israelmore Ayivor	You cannot score a goal when you are sitting on the bench. To do so, you have to dress up and enter the game.
Leigh Brackett	You can't destroy knowledge. You can stamp it under and burn it up and forbid it to be, but somewhere it will survive.
Steven Wright	You can't have everything. Where would you put it?
Kate Braverman	You can't know a father. They're all magicians. Got two million years of strings and mirrors in their pockets.
W. Somerset Maugham	You can't learn too soon that the most useful thing about a principle is that it can always be sacrificed to expediency.
Galileo Galilei	You can't teach anybody anything, only make them realize the answers are already inside them.
Cassandra Clare	You could not erase everything that caused you pain with recollection.Every memory was valuable; even the bad ones
Aquib Ali	You fall at times and that's how you learn.
Neil Gaiman	You get what anybody gets - you get a lifetime.
Israelmore Ayivor	You got to insist on your success, resist every obstacle and persist in times of difficulty and you will get there.
Ethel Barrymore	You grow up the day you have your first real laugh – at yourself.
Vernon Howard	You have succeeded in life when all you really WANT is only what you really NEED.
Sunday Adelaja	You have to discover what makes you different in your society.
A.P.J. Abdul Kalam	You have to dream before your dreams can come true.
Carl Sagan	You have to know the past to understand the present.
Idowu Koyenikan	You just can't let life happen to you, you have to make life happen.
Atef Ashab Uddin Sahil	You just wasted a question by asking, "May I ask you a question?
Jim Butcher	You know how confusing the whole good-evil concept is for me.
Coco Chanel	You live but once; you might as well be amusing.
Muhammad Ali	You lose nothing when fighting for a cause ... In my mind the losers are those who don't have a cause they care about.
Benjamin Franklin	You may delay, but time will not.
Napoleon Hill	You might well remember that nothing can bring you success but yourself.
Ellyn Bache	You move forward. You face up to your challenges. You don't retreat. You're young, and sometimes you'll wish you could. But don't.
Roz Inga	You need to be buried deep in the dirt before you can find your bloom.
Shaun Hick	You need to spend time crawling alone through shadows to truly appreciate what it is to stand in the sun.
Roy T. Bennett	You never change your life until you step out of your comfort zone; change begins at the end of your comfort zone.
Warren Buffett	You only have to do a very few things right in your life so long as you don't do too many things wrong.
Chuck Palahniuk	You realize that our mistrust of the future makes it hard to give up the past.
Jim Butcher	You rush a miracle worker, you get lousy miracles!
Kit Williams	You see, my ambition was not to confound the engineering world but simply to create a beautiful piece of art.
	You should make a point of trying every experience once, excepting incest and folk dancing.
Jens Christian Grøndahl	You shouldn't think about the past so much...Looking back only gives you a stiff neck.
Unknown	You stare at frozen juice cans because they say, "concentrate".
Alex Zanardi	You want to climb the mountain because it's there and you know you can do it.
Roy T. Bennett	You were born to stand out, stop trying to fit in.
Toni Sorenson	You will never get to a new place by walking an old path.
Unknown	You'd think that with NSA reading our tweets all the time, they could star or retweet some of the good ones.
Charlie Chaplin	You'll never find a rainbow if you're looking down
Isaac Asimov	Your assumptions are your windows on the world. Scrub them off every once in a while, or the light won't come in.
Lisa Nichols	Your best opportunities are out on the skinny branch.
Jon Scieszka	Your brain is doing some great work when it's laughing.
Toni Sorenson	Your challenge will never get easier, but you will get stronger if you don't quit.
Sunday Adelaja	Your daily product determines how far you go
Steve Pavlina	Your environment will eat your goals and plans for breakfast.
Steve Maraboli	Your life isn't behind you; your memories are behind you. Your life is ALWAYS ahead of you. Today is a new day - seize it!
Doris P. Johnson	Your mission or purpose is like a magnet that keeps you moving is a well established direction
Desmond Tutu	Your ordinary acts of love and hope point to the extraordinary promise that every human life is of inestimable value.
Lisa Nichols	Your story is important.
Richard Bach	You're never given a dream without also being given the power to make it true.
	You're no good unless you are a good assistant; and if you are, you're too good to be an assistant.
	You've got to make a conscious choice every day to shed the old - whatever 'the old' means for you.
